a1	阿啊呵腌吖锕錒
a2	啊呵嗄阿
a3	啊呵
a4	啊呵阿
a5	阿啊呵
ai1	哀挨埃唉哎捱锿诶嗳銰鎄
ai2	呆挨癌皑捱矮凒啀娾崖嵦敱敳皚睚騃
ai3	矮哎蔼霭嗳毐佁噯昹欸藹诶躷靄馤
ai4	爱碍艾唉哎隘暧嗳瑷嗌嫒砹愛叆乂伌僾噯堨塧嬡懓懝曖欸濭璦皧瞹硋礙薆譪賹鑀靉鱫鴱
an1	安谙鞍氨庵桉鹌胺侒厂厈厰垵媕峖广広廠廣痷盦盫腤萻葊蓭誝諳銨鞌韽鵪
an3	俺铵揞埯唵堷晻罯銨隌
an4	案按暗岸黯胺犴闇晻儑匎匼堓婩洝荌菴豻貋錌鮟黬
ang1	肮骯
ang2	昂卬岇昻
ang4	盎枊醠
ao1	熬凹柪梎軪
ao2	熬敖嚣嗷鏖鳌翱獒聱螯廒遨璈厫嗸囂嶅摮滶爊獓磝翺蔜謷謸隞鰲鷔鼇
ao3	袄拗媪媼抝芺襖镺
ao4	奥澳傲懊坳拗骜岙鏊垇墺奡奧嫯嶴慠扷擙澚詏驁
ba1	八吧巴叭芭扒疤笆粑岜捌豝仈哵夿朳玐紦羓釟魞鲃
ba2	八拔跋茇菝魃叐坺墢妭抜炦犮秡胈詙軷鈸馛鼥
ba3	把靶钯q欛鈀
ba4	把爸罢霸坝耙灞鲅壩鲌伯垻弝欛猈罷覇鮁鮊
ba5	吧罢巴叭杷琶罷
bai1	掰擘
bai2	白百
bai3	百摆伯柏佰捭兡擺栢矲竡粨絔襬
bai4	败拜呗稗唄庍拝敗矲粺薭蛽贁
ban1	般班搬斑颁扳瘢癍攽斒朌肦虨螌褩辬頒
ban3	版板阪坂钣舨岅昄瓪粄蝂鈑闆
ban4	办半伴扮瓣拌绊柈姅怑湴爿秚絆辦鉡靽
bang1	帮邦浜梆傍垹幇幚幫捠縍邫鞤
bang3	膀榜绑牓牕綁髈
bang4	棒膀傍磅谤镑蚌蒡塝搒旁棓稖艕蜯謗鎊
bao1	包胞炮剥褒苞孢煲龅襃枹勹笣蕔齙
bao2	薄雹保嫑瓝窇
bao3	保宝饱堡葆褓鸨堢媬宲寚寳寶怉珤緥賲靌飽駂鳵鴇
bao4	报暴抱爆鲍曝刨瀑豹趵儤勽嚗報忁曓犦菢虣蚫袌鉋鑤铇鮑
bei1	背悲杯碑卑陂埤萆鹎伓俾偝庳揹桮椑盃禆綼裨錃鵯
bei3	北鉳
bei4	被备背辈倍贝蓓惫悖狈焙邶钡孛碚褙鐾鞴琲俻偹備僃哱奰愂憊昁梖牬犕狽珼竡糒紴臂誖貝軰輩郥鄁鋇鞁韛
bei5	臂呗备唄
ben1	奔贲锛栟泍渀犇賁逩錛
ben3	本苯畚夲奙楍
ben4	奔笨夯坌渀体倴捹撪桳犇獖輽
beng1	崩绷嘣祊伻塴奟嵭弸絣綳繃閍
beng2	甭
beng3	绷埲玤琫綳菶誁鞛
beng4	绷蹦迸甏泵蚌堋槰綳蜯跰逬鏰镚
bi1	逼偪屄毴皀稫螕豍鲾
bi2	鼻荸匕比
bi3	比笔彼鄙匕俾妣吡秕舭佊啚夶屄朼柀沘潷疕筆粃貏
bi4	必毕币秘避闭壁臂弊辟碧拂毙蔽庇璧敝泌陛弼篦婢愎痹铋裨濞髀庳毖滗蓖埤芘嬖荜贲畀萆薜筚箅哔襞跸狴鷩閟觱苾皕坒诐佖俾咉嗶堛妼嫳幣幤廦弻彃怭愊払斃朇枈柫柲梐楅檘比湢滭潷煏熚獘獙珌畢疪痺睥稗箄箆篳粊縪罼聛腷蓽蜌袐襒襣詖貱賁贔赑蹕躃躄邲鄙鄨鄪鉍鎞鏎鐴閇閉闢鞸韠飶饆馝駜驆骳魓鮅鰏鵖鷝鼊
bian1	编边鞭砭煸蝙笾鳊辺柉楄牑猵獱甂稨箯籩編邉邊鍽鯾鯿
bian3	贬扁匾碥窆褊惼糄萹藊貶
bian4	便变遍辩辨辫卞苄汴忭弁缏変徧抃揙昪汳炞玣緶艑覍變辡辧辮辯釆閞鴘
bian5	边
biao1	标彪勺镖膘骠镳杓飚飑飙瘭髟摽臕儦墂幖標滮瀌灬熛爂猋磦穮羆脿蔈藨謤贆鏢鑣颩颮颷飆飇飈飍驃驫骉麃
biao3	表裱婊檦俵褾諘錶
biao4	鳔俵摽鰾
bie1	憋瘪鳖癟虌鱉鼈龞
bie2	别蹩別咇徶莂蟞襒
bie3	瘪癟蛂
bie4	别彆縪
bin1	宾滨彬斌缤濒槟傧玢豳镔邠儐梹椕檳汃濱濵濹瀕瑸璸矉繽蠙豩賓賔鑌霦顮馪驞
bin4	鬓殡摈膑髌儐擯殯臏髕髩鬂鬢鶣
bing1	并兵冰槟冫仌傡掤栟梹檳氷竝
bing3	饼屏丙柄秉炳禀邴摒昺鞆庰怲抦昞棅琕眪稟窉苪蛃鈵鉼陃鞞餅餠
bing4	并病摒並併倂偋傡寎幷柄栤竝靐鮩鵧
bo1	波播拨剥玻饽菠钵趵鲅啵般蕃嶓剝岥撥柭癶盋砵碆缽袚襏蹳鉢餑驋髉鱍
bo2	博伯勃薄泊柏驳魄脖搏膊舶礴帛铂箔渤钹孛亳鹁踣饽玻鎛侼僰嶏愽懪挬敀栢桲檗欂浡煿牔犱犻猼百礡簙糪胉艊苩葧蔔袯襮謈踄郣鉑鋍鑮镈餺馎馞駁駮骲髆鲌鵓鸔
bo3	簸跛箥蚾駊
bo4	薄柏簸掰擘檗孹挀播狛疈繴薜蘗譒
bo5	卜啵膊蔔
bu1	逋晡钸不峬庯鈽餔鵏
bu2	不醭补
bu3	补捕堡卜哺卟埔獛蔔補鳪
bu4	不部布步怖簿埔埠瓿钚唔歩佈勏咘埗悑捗歨篰荹蔀郶鈈鈽餢
ca1	擦拆嚓
ca3	礤
cai1	猜偲
cai2	才财材裁采纔戝溨財
cai3	采彩踩睬倸婇寀採棌綵跴
cai4	采菜蔡埰縩
can1	参餐骖參叅湌蓡薓謲飡驂
can2	残惭蚕嬠嬱慙慚殘蝅蠶蠺
can3	惨黪噆慘憯朁黲
can4	惨灿掺璨孱粲慘澯燦薒
cang1	苍仓沧舱伧仺倉傖凔嵢滄艙蒼螥鶬鸧
cang2	藏匨蔵鑶
cao1	操糙喿撡鄵
cao2	曹槽嘈漕螬艚草嶆曺蓸褿鏪
cao3	草愺懆艸艹騲
ce4	策测侧厕册恻側冊厠墄嫧廁惻憡拺敇測溭畟矠笧筞筴箣粣茦荝萗蓛遪
cen1	参參叅嵾梫薓
cen2	岑涔埁梣橬笒
ceng1	噌
ceng2	曾层竲層嶒曽碀鄫
ceng4	蹭
cha1	差插叉碴喳嚓杈馇锸茶偛嗏嫅扠扨挿揷疀肞艖銟鍤鎈餷
cha2	查察茶叉茬碴楂猹搽槎檫詧嵖垞査秅臿鍤
cha3	叉衩镲蹅鑔
cha4	差刹叉诧岔衩杈汊姹仛侘剎奼紁訍詫
chai1	差拆钗偨芆釵
chai2	柴豺侪儕喍犲祡
chai4	虿瘥囆蠆袃
chan1	搀掺觇嬓惉摻攙梴欃袩襜覘辿鋓
chan2	单缠禅蝉馋潺蟾婵谗廛孱镡澶躔产瀍僝劖単單嚵壥嬋孨巉棎毚湹潹瀺煘獑磛禪緾繵纏纒艬蟬誗讒鄽酁鋋鐔鑱镵饞
chan3	产铲阐谄冁蒇骣丳刬剗剷啴嘽囅嵼幝摌旵浐滻灛燀產産簅繟蕆諂譂讇鏟閳闡
chan4	颤忏羼儳懴懺硟韂顫
chang1	昌娼猖伥阊菖鲳倀倡晿淐琩裮錩锠閶鯧鼚
chang2	长场常尝肠偿倘裳嫦徜苌厂仧償兏嘗嚐場塲瑺瓺甞粻腸膓萇鋿鏛長镸鱨鲿
chang3	场厂敞氅昶惝僘厈厰場塲廠鋹
chang4	唱畅倡怅鬯玚悵暢焻畼誯韔
chao1	超抄吵钞绰剿焯怊勦巐弨欩罺訬鈔
chao2	朝潮嘲巢晁炒巣樔謿轈鄛鼂鼌
chao3	炒吵的蛋煼眧麨
chao4	耖仦仯觘
che1	车砗伡俥唓硨莗蛼車
che3	扯偖奲尺撦
che4	彻撤澈掣坼辙勶屮徹烲爡瞮硩聅轍迠
chen1	郴琛嗔抻瞋堔搷棽諃謓賝
chen2	陈沉晨沈尘臣辰橙忱谌宸陳伔塵娠屒愖敐曟樄煁茞莀莐蔯薼螴訦諶軙迧鈂霃鷐麎
chen3	碜墋捵硶磣裖贂趻踸鍖齓
chen4	称趁衬秤谶榇龀儭嚫夦櫬疢稱穪藽襯讖趂齔
chen5	伧
cheng1	称撑秤瞠噌铛柽蛏偁埥崝憆摚撐棦橕檉泟浾牚牜琤稱穪竀緽蟶赪赬鏿鐺阷靗頙頳饓
cheng2	成城程承诚盛乘呈惩澄橙丞埕枨塍铖裎酲晟郕乗堘塖娍宬峸憕懲挰掁揨棖椉洆澂瀓珵珹畻窚筬絾脀脭荿誠鋮騬
cheng3	逞骋裎侱塣庱徎悜睈騁
cheng4	称秤偁牚稱穪
chi1	吃痴哧嗤蚩笞鸱媸螭眵魑摛絺喫噄妛彨彲瓻癡瞝訵誺貾鴟鵄麶黐齝齹
chi2	持迟池驰匙弛踟墀茌篪坻侈俿岻徥徲忯栘歭汦竾筂箈箎耛荎蚔蚳謘貾赿趍遅遟遲馳
chi3	尺齿耻侈褫豉呎歯伬傂叺垑姼恀恥扡拸欼禠粎蚇袳裭誃鉹鶒齒
chi4	赤斥翅啻炽敕叱饬傺彳瘛眙鶒侙勅恜慗憏懘戠抶摰杘栻淔灻烾熾痓痸糦翄翤趩跮鉓銐飭饎鷘
chong1	冲充涌憧忡艟舂茺衝嘃徸摏沖浺湧珫祌翀蹖
chong2	重崇虫崈漴痋种種翀蝩蟲褈隀
chong3	宠寵
chong4	冲铳揰衝銃
chou1	抽瘳婤搊犨犫篘霌
chou2	愁仇筹酬绸踌惆畴稠帱俦雠讐雔儔嚋嬦幬懤栦椆燽疇皗籌紬絒綢菗薵裯詶讎躊酧醻鯈
chou3	丑瞅丒侴吜杻杽矁莥醜魗
chou4	臭憱殠臰霔
chu1	出初樗约岀貙齣
chu2	除厨躇橱雏锄蜍刍滁蹰处储蓄鉏儲墸幮廚曯櫉櫥犓篨耡芻蒢蒭蕏趎跦躕鋤雛鶵
chu3	处楚储础杵褚楮儲処椘檚濋礎處齭齼
chu4	处触畜矗怵搐绌黜亍憷柷俶傗儊処拀敊斶欪歜泏滀琡竌竐絀臅荲處觸詘豖踀遚鄐閦
chuai1	揣搋
chuai3	揣
chuai4	揣啜踹嘬膪
chuan1	穿川巛氚瑏窓鐉
chuan2	传船遄椽舡傳暷歂牀篅舩諯輲
chuan3	喘舛僢堾荈
chuan4	串钏剏汌玔賗釧
chuang1	创窗疮刅創囪憃戧摐瘡窻
chuang2	床幢撞橦疒
chuang3	闯搶摤漺闖
chuang4	创怆刱剙創愴獊闖
chui1	吹炊龡
chui2	垂锤捶陲椎槌棰倕圌埀娷搥湷甀箠腄菙錘鎚顀
chun1	春椿蝽媋旾暙杶櫄焞瑃箺膥萅輴鰆鶞
chun2	纯唇醇淳鹑莼憌浱湻滣漘純脣蒓蓴醕錞陙鯙鶉
chun3	蠢偆惷睶萶踳
chuo1	戳踔
chuo4	绰啜辍龊吷嚽娖婥婼惙擉歠涰珿畷磭綽繛腏諁趠輟辵辶逴酫醊鑡齪齱
ci1	差刺疵呲庛赼趀雌骴
ci2	词辞慈磁瓷兹茨雌祠茈鹚糍垐嬨柌濨珁甆疵粢薋詞辝辤辭飺餈鷀
ci3	此泚词佌玼皉跐
ci4	次刺赐伺剌蚝佽刾廁朿栨絘莿蛓賜
cong1	从匆聪葱囱苁骢璁枞聡囪從悤暰棇樅樬漗焧熜燪瑽瞛篵繱聦聰蓯蔥蟌鍐鏦騘驄
cong2	从丛琮淙叢婃孮従徖從悰慒樷漎潀灇爜誴賨賩錝
cou4	凑楱辏腠湊輳
cu1	粗觕麁麄麤
cu2	徂殂豠
cu4	促簇醋卒猝蹴蹙蔟酢粗噈梀槭殧瘯縬脨趗趣趨踧錯鏃鼀
cuan1	蹿撺汆镩攛躥鋑鑹
cuan2	攒劗巑攅攢櫕
cuan4	窜篡爨殩熶竄篹簒
cui1	衰催摧崔隹榱脆嗺墔槯獕磪缞鏙
cui3	璀漼趡
cui4	脆粹萃翠瘁悴淬毳啐伜倅啛忰橇濢焠焫琗疩竁粋紣綷脃脺膬膵臎顇
cun1	村皴邨澊竴
cun2	存蹲袸
cun3	忖刌
cun4	寸吋籿銌
cuo1	搓撮磋蹉睉蒫遳髊
cuo2	嵯矬痤瘥鹾嵳蔖虘酂醝鹺
cuo3	撮脞瑳硰縒
cuo4	错措挫厝锉侳剉剒撮歵莝莡蓌逪銼錯齰
da1	答搭嗒耷褡哒瘩荅咑噠撘
da2	打达答瘩沓鞑怛笪靼妲哒炟鎉匒呾畗畣繨荅荙薘蟽詚逹達鐽闒阘韃
da3	打大
da4	大汏眔
da5	塔疸瘩垯墖墶跶
dai1	待呆呔懛獃
dai3	逮歹傣歺
dai4	大代带待戴袋贷逮殆黛怠玳岱迨骀绐埭甙帶襶叇帒帯廗忕曃柋汏瀻瑇簤紿緿艜貸跢蹛軚軩轪酨霴靆黱
dan1	单担丹耽眈殚箪儋瘅聃郸勯匰単單嚪妉媅擔殫甔癉砃簞耼聸襌躭鄲酖頕
dan3	担胆掸赕疸瘅亶丼刐撢撣擔澸玬瓭癉紞膽衴賧黵
dan4	但担石弹淡旦蛋诞惮啖澹氮萏瘅吐禫亶僤啗啿嘾噉帎幨弾彈憚憺擔暺柦殫沊泹潬灗狚疍癉癚窞腅舕蜑觛誕霮饏馾駳髧鴠
dang1	当裆铛當珰儅噹嵣澢璫筜簹艡蟷襠鐺鑁
dang3	党挡谠档擋攩檔欓灙譡讜黨
dang4	当荡档挡宕菪凼砀垱圵壋愓擋氹璗瓽當盪瞊碭礑簜蕩蘯趤逿闣雼
dao1	刀叨忉氘刂幍朷舠釖魛鱽
dao2	叨导捯
dao3	导倒岛蹈捣祷嶋壔導島嶌嶹搗擣禂禱隝隯
dao4	到道倒悼盗稻焘纛噵導帱幬檤燾瓙盜稲翿菿衜衟軇
de2	得德锝嘚徳恴悳惪棏淂鍀
de4	嘚
de5	的地得底
dei3	得
deng1	登灯蹬噔簦嬁燈璒竳蕽覴豋鐙
deng3	等戥朩
deng4	邓凳瞪澄蹬磴镫嶝僜墱櫈澂邆鄧鐙隥霯
di1	提低滴堤嘀氐镝羝的鍉磾仾啇埞墑奃彽眡袛趆鏑鞮
di2	敌笛的迪涤嘀狄嫡翟荻籴觌镝仢唙嚁廸敵梑滌潪犒篴糴芽苖蔋蔐藋藡覿豴蹢鏑靮頔鸐
di3	底抵诋邸砥坻柢氐骶呧坘弤拞掋牴聜茋菧觝詆軧阺
di4	地第帝弟递蒂缔谛睇棣娣碲绨的俤遰逓偙僀哋啲坔埊墆嵽嶳怟慸摕旳杕梊楴樀渧焍爈玓珶甋祶禘綈締肑腣菂蔕虳螮諦踶軑遞釱鉪馰
dia3	嗲
dian1	颠滇掂癫巅甸傎厧嵮巓巔攧敁槇槙瘨癲蹎顚顛齻
dian3	点典碘踮丶點嚸奌婰琠蕇錪
dian4	电店甸淀垫殿奠惦佃玷簟坫靛钿癜阽墊壂婝扂敟橂澱琔痁磹蜔鈿電
diao1	雕刁凋叼貂碉鲷鵰奝弴彫扚殦汈琱瞗虭蛁鮉鯛鳭鼦
diao3	鸟屌
diao4	调掉吊钓铫铞調伄弔瘹窎窵竨蓧訋誂釣銚銱鋽鑃魡
die1	爹跌踮嗲褺
die2	叠迭碟谍蝶喋佚牒耋蹀堞瓞揲垤鲽咥峌嶀恎惵戜挕昳曡楪氎牅畳疂疉疊眣眰絰绖耊聑胅臷艓苵蜨褋詄諜趃跌跕镻鰈
ding1	丁盯钉叮町酊疔仃耵玎帄甼虰釘靪
ding3	顶鼎酊奵嵿檙濎薡鐤頂鼑
ding4	定订钉铤腚锭碇啶娗忊掟椗矴碠磸萣訂釘鋌錠顁飣饤
diu1	丢铥丟乣銩
dong1	东冬咚岽氡鸫倲埬娻崠崬昸東氭涷炵笗苳菄蝀鯟鶇鼕
dong3	懂董硐墥嬞箽
dong4	动洞冻栋恫侗垌峒胨胴硐動働凍戙挏棟腖霘駧
dou1	都兜蔸篼督嘟唗兠吺橷郖
dou3	斗抖陡蚪唗唞敨枓枡闘阧鬥鬦鬪鬭
dou4	读斗豆逗窦痘闘脰斣梪毭浢竇荳読讀鋀閗餖饾鬥鬦鬪鬬鬭
du1	都督嘟阇厾醏闍
du2	读独顿毒渎牍犊黩髑椟儥凟匵嬻櫝殰涜瀆牘犢獨瓄皾纛蝳読讀讟豄贕鑟韇韥頓騳黷
du3	肚睹堵赌笃覩帾暏琽篤裻賭錖
du4	度渡肚杜妒镀芏蠹喥妬斁殬秺簵荰螙蠧鍍靯
duan1	端偳剬媏耑褍
duan3	短鍴
duan4	断段锻缎煅椴簖塅斷毈瑖碫籪緞腶葮躖鍛
dui1	堆垖塠嵟痽磓頧
dui4	对队兑敦碓憝怼镦對兊兌対憞懟濧濻瀩綐薱譈轛鐓鐜陮隊
dun1	吨敦蹲墩礅镦惇墪噸撉撴犜蜳蹾鐓驐
dun3	盹趸躉
dun4	顿盾钝炖遁沌囤砘楯伅噸坉崸庉扽潡燉腞踲逇遯鈍頓鶨
duo1	多咄哆掇裰剟嚉夛崜柁茤
duo2	度夺踱铎掇凙剫奪敓敚敠敪椯毲痥腏莌襗鈬鐸鮵
duo3	朵躲垛哚缍嚲亸垜埵挅挆朶痑綞趓躱軃鬌
duo4	舵堕跺剁惰垛驮沲柁刴咄垜墮墯尮嶞度憜柮桗炧炨貀跥陊陏飿饳馱駄鵽
e1	阿婀屙妸妿娿峉痾錒
e2	额俄哦鹅娥峨蛾讹莪锇扼吪囮峩涐珴皒睋磀訛誐譌迗鈋鋨頟額騀魤鵝鵞
e3	恶悪惡
e4	恶饿扼愕遏噩呃厄鄂轭颚鳄谔锷萼腭垩鹗苊阏惡俄偔僫卾呝咢咹圔堊堨堮屵岋崿嶭悪戹搤搹枙櫮湂琧砐砨硆蕚蘁蚅蝁覨詻諤讍豟貖軛軶遌鍔鑩閼阨阸頞顎餓餩鰐鱷鶃鶚齶
e5	呃
ei2	诶
ei3	诶
ei4	诶
en1	恩蒽奀
en4	摁嗯
er2	而儿鸸鲕洱耳兒輀侕児唲栭檽洏耏聏胹荋袻轜陑隭髵鮞鴯
er3	尔耳迩饵洱珥铒尓尒峏栮爾薾邇鉺餌駬
er4	二贰佴弐刵咡弍樲毦眲聏衈誀貮貳
fa1	发発伐彂橃發瞂酦醗醱颰
fa2	罚乏伐阀筏垡砝傠姂栰栿牫疺笩罰罸茷藅閥
fa3	法砝佱灋珐髮
fa4	发珐髪琺蕟髮
fan1	翻番帆藩幡蕃籓噃僠嬏旙旛繙轓飜鱕
fan2	凡烦繁泛樊蕃燔矾蘩钒蹯帆璠凢凣勫匥墦忛憣杋柉棥橎瀪瀿煩礬笲籵緐羳膰舧薠藩蠜襎釩鐇颿鷭
fan3	反返仮魬
fan4	饭犯范贩泛梵畈飯氾奿嬎嬔汎滼盕笵範訉販軓軬鄤飰
fang1	方芳妨坊邡枋钫匚汸淓牥蚄鈁鴋
fang2	房防妨坊肪鲂埅魴
fang3	访仿纺彷舫紡昉倣旊昘瓬眆訪髣鶭
fang4	放趽
fei1	非飞啡菲扉霏妃绯蜚鲱婓渄緋裶靟飛飝馡騑騛鯡
fei2	肥腓淝萉蜰
fei3	菲匪诽斐蜚翡悱篚榧奜朏棐猆蕜誹餥
fei4	费废沸肺吠痱狒镄芾砩俷剕厞屝廃廢怫昲曊杮櫠濷疿癈胇蟦費鐨靅鼣
fen1	分纷氛芬吩酚玢棻兝岎帉昐朆梤砏竓竕紛翂衯訜鈖隫雰餴饙鳻
fen2	坟焚汾棼鼢蚡坆墳妢幩弅枌濆炃燌燓羒蒶蕡蚠豮豶轒鐼馚馩黂鼖
fen3	粉黺
fen4	分份奋愤粪忿偾瀵鲼僨坋奮憤橨秎糞羵膹魵鱝
feng1	风封丰峰疯锋蜂枫烽酆葑沣砜讽鋒仹偑僼凨凬凮妦寷峯崶捀桻楓檒沨灃熢犎猦瘋盽碸篈莑蘴蠭諷豊豐鄷鏠靊風飌麷
feng2	逢缝冯堸夆摓浲渢漨綘縫艂馮
feng3	讽唪覂諷
feng4	奉缝凤俸葑鳳鳯湗焨煈縫諷賵赗鴌
fo2	佛仏坲髴
fou3	否缶不殕缹缻雬鴀
fu1	夫肤敷孵呋稃麸趺跗芙鄜伕妋姇尃怤旉柎泭玞璷砆筟箙箻粰糐紨綒罦膚荴衭豧邞鈇鳺麩麬麱
fu2	夫服福佛幅伏符浮扶弗拂袱俘芙孚匐辐涪氟桴蜉苻茯莩菔幞怫艴郛绂绋凫祓砩黻罘稃蚨芾蝠抚缚彿巿榑洑茀乀仏刜咈咉垘岪帗懯払昲枎枹柫棴沷澓炥烰玸琈甶畉癁笰紱紼絥綍縛翇艀葍虙袚諨踾輻鉘鉜韍韨颫髴鮄鳧鳬鴔鵩鶕鶝
fu3	府父腐抚辅甫俯斧脯釜腑拊滏黼符莆伏腹俛頫乶俌冹嘸弣捬撫暊焤盙秿簠蚥蜅軵輔郙釡鬴鯆
fu4	服复父负副富付妇附赴腹覆赋傅缚咐阜讣驸赙馥蝮鲋鳆負阝冨袝褔偩坿姇婏婦媍峊復椱榑洑畐祔稪竎緮胕萯蕧蚹蛗蝜複訃詂賦賻輹鍑鍢陚駙鮒鰒
fu5	咐服袱夫腐复
ga1	咖嘎胳伽旮呷嘠夹
ga2	嘎噶轧尜钆軋釓錷
ga3	嘎尕玍
ga4	尬
gai1	该赅垓陔侅姟峐晐畡祴荄該豥賅賌郂隑
gai3	改忋攺絠胲
gai4	概盖丐钙芥溉戤匄槩乢匃摡槪漑瓂蓋鈣魪
gan1	干甘肝杆尴乾竿坩苷柑泔矸疳酐乹亁凲咁尲尵尶尷嵅幹忓攼玕筸粓虷蜬迀鳱
gan2	赶敢
gan3	感敢赶杆橄秆擀澉扞仠桿皯盰稈衦贑趕鱤鳡
gan4	干赣淦绀旰乾幹倝凎嵅榦檊汵涻灨簳紺芉詌贛骭
gang1	刚钢纲缸扛杠冈肛罡剛冮堈堽岗岡崗掆棡犅疘碙笐綱罁罒釭鋼鎠
gang3	港岗塂崗
gang4	钢杠戆筻戅槓焵鋼
gao1	高糕膏皋羔睾篙槔槹橰櫜滜皐睪羙臯韟餻髙鼛
gao3	稿搞藁槁缟镐杲夰攪暠檺稾筶縞菒藳鎬
gao4	告膏诰郜锆吿q煰祮祰禞誥鋯鯌
ge1	歌格哥戈割胳搁疙咯鸽屹仡圪纥袼鴐戓戨擱渮滒紇肐謌鎶鴚鴿麧
ge2	革格隔葛阁胳搁蛤嗝骼颌搿膈镉塥鬲噶閤佮匌呄咯愅挌擱敆敋槅獦臵茖蛒裓觡諽輵轕鎘閣鞷韐韚鮯鰪齃
ge3	个各合盖葛哿舸擖笴葢蓋騔魺
ge4	个各铬硌虼個嗰箇鉻鶮
gei3	给給q
gen1	根跟刯
gen2	哏
gen3	艮
gen4	亘艮茛亙
geng1	更耕庚羹赓畊揯搄浭粳絙絚緪縆羮菮賡鶊鹒
geng3	耿颈梗哽鲠埂绠峺挭綆莄郠頚頸骾鯁
geng4	更亙堩暅
gong1	工公共红供功攻宫恭躬龚弓肱蚣觥匑嗗塨宮幊愩杛疘碽竍竏竓竔竕竡篢糼紅觵躳釭龏龔
gong3	巩拱汞珙栱共廾拲礦穬蛬銾鋛鞏鞐
gong4	共供贡唝摃羾貢
gou1	句沟勾钩篝佝枸缑鞲溝緱芶褠鈎鉤
gou3	狗苟岣枸笱玽耇耉茍茩蚼豿
gou4	够购构勾觏垢诟媾遘彀傋冓唦坸夠姤搆撀構簼覯訽詬購雊韝
gu1	姑骨孤估辜咕呱箍沽菇轱鸪毂菰蛄酤觚夃嫴家柧橭泒痼笟箛罛苽蓇軱軲轂鈲鈷鮕鴣
gu2	骨古鼓谷鶻
gu3	古股鼓骨谷贾汩蛊毂鹄牯臌诂瞽罟钴嘏蛄鹘榖穀凸唂唃尳愲扢杚淈滑濲瀔牱狜皷皼盬糓縎羖脵薣蛌蠱詁賈轂鈷餶馉鵠鶻鼔
gu4	故顾固估雇锢梏牿崮痼鲴堌僱凅吿告崓棝榾祻稒錮頋顧鯝
gua1	括瓜刮呱栝胍鸹蜗劀懖煱瘑筈緺聒腡膼葀蝸趏踻銽頢颳騧鴰
gua3	寡呱剐冎剮叧
gua4	挂褂卦诖啩掛絓罣罫詿髺
guai1	乖掴宔摑
guai3	拐枴柺箉
guai4	怪叏夬廥恠旝癐
guan1	关观官冠棺矜莞倌纶鳏関観唍瘝癏綸蒄覌觀闗關鰥鱞
guan3	管馆莞琯唍圕痯筦舘輨錧館鳤
guan4	观惯冠贯罐灌掼盥涫鹳丱悹悺慣摜樌毌泴潅爟瓘矔礶祼罆観觀謴貫遦鏆鑵雚鱹鸛
guang1	光咣胱桄洸侊僙垙姯灮炗炚烡珖茪輄銧黆
guang3	广犷広廣獷
guang4	逛桄櫎矌臦臩
gui1	规归瑰龟硅闺皈傀圭妫鲑珪邽槻亀媯嫢嬀帰摫椝槼歸溈璝瓌窐膭袿規郌閨鬶鬹鮭龜
gui3	鬼轨诡癸匦庋宄晷簋佹匭厬垝姽庪恑攱氿祪蛫蟡觤詭軌陒
gui4	贵桂跪柜刽炔刿桧炅鳜匮劊劌嶡巜攰昋暩楿檜櫃溎筀蓕貴鞼鱖鱥
gun3	滚鲧衮绲磙辊混掍滾緄蓘蔉袞輥鮌鯀
gun4	棍璭睴
guo1	过锅郭涡聒蝈崞埚呙墎咼啯嘓堝渦濄蟈過鈛鍋
guo2	国帼掴馘虢囯囶囻圀國幗慖摑漍簂聝腘膕
guo3	果裹猓椁蜾叵粿惈槨淉綶菓輠錁鐹餜馃
guo4	过過果腂
ha1	哈铪鉿
ha2	虾蛤蝦鰕
ha3	哈
ha4	哈
hai1	嘿咳嗨和咍
hai2	还孩骸海還
hai3	海胲醢烸酼
hai4	害亥骇氦嗐絯餀饚駭
han1	酣憨顸鼾蚶唅嫨炶犴甝谽頇馠魽
han2	含寒汗韩涵函晗焓邯邗肣咁佄凾圅娢崡梒榦浛琀筨鋡韓
han3	喊罕阚厂厃嚂浫蔊豃闞
han4	汉汗憾翰撼旱捍悍瀚焊颔菡撖傼哻垾屽扞攌晘晥暵涆淊漢澏熯犾猅皔睅莟蛿蜭螒譀豻釬銲鋎閈闬雗頜頷顄馯駻鶾
hang1	夯
hang2	行航吭杭绗珩颃斻桁筕絎苀蚢貥迒雽頏魧
hang4	行巷沆
hao1	蒿薅嚆侾傐
hao2	号毫豪嚎壕貉嗥濠蚝好儫勂嘷噑椃狢獆獋獔籇號蠔諕譹鶴
hao3	好郝恏
hao4	好号浩耗皓昊灏镐颢哠峼悎昦晧暤暭曍涸淏滈澔瀥灝皜皞皡皥秏聕薃號鄗鎬顥鰝
he1	喝呵诃嗬哬峆抲訶
he2	和何合河核盒禾荷阂涸阖貉曷颌劾菏盍纥蚵翮褐鞨郃龢俰咊啝姀嵑廅惒柇楁毼滆澕熆狢盇盉礉秴篕紇萂蒚蓋蝎螛覈訸詥貈趷釛鉌閡閤闔頜餲饸魺鶡鹖齕龁
he4	和何喝赫吓贺荷鹤壑褐佫咊嗃嚇寉暍煂熇爀猲癋皬碋翯蠚袔賀隺靎靏鶴鸖
hei1	黑嘿嗨黒潶
hen2	痕很拫鞎
hen3	很狠詪
hen4	恨
heng1	哼亨亯悙脝諻
heng2	横衡恒蘅珩桁行佷姮恆揘楻橫誙諻鑅鴴鸻
heng4	横啈堼撔橫澋絎
hng5	哼
hong1	轰哄烘薨訇叿吽呍哅揈渹焢硡谾軣輷轟鍧閧顭魟
hong2	红洪鸿宏虹弘泓闳蕻黉荭鋐紘纮竑烘仜垬妅娂宖峵彋汯浤渱潂灴玒玜瓨硔竤篊粠紅紭綋翃翝耾舼苰葒葓訌谹谼鈜鉷閎霟鞃鴻黌
hong3	哄嗊晎閧
hong4	哄讧蕻汞澒訌鍙閧鬨
hou2	侯喉猴瘊篌糇骺帿睺矦翭葔銗鍭餱鯸
hou3	吼犼
hou4	后候後厚侯逅堠鲎郈垕洉矦缿豞鄇鮜鱟鲘
hu1	乎呼戏忽糊惚唿滹轷烀匢匫吰啒嘑垀寣峘幠恗戯戲昒曶欻歑歘泘淲淴烼膴苸虍虖謼軤雐餬
hu2	和胡湖糊核壶狐葫弧蝴囫瑚斛鹄醐猢槲鹕觳煳鹘縠喖嘝壷壺媩抇搰楜瀫焀猤瓳箶絗蔛螜衚鍸頶餬鬍魱鰗鵠鶘鶦鶻鼓
hu3	虎浒唬琥乕汻滸萀虝許
hu4	护户互糊虎沪祜扈戽笏岵怙瓠鹱冱戸乕冴嚛婟嫭嫮帍弖怘戶摢昈枑楛槴沍滬熩簄綔臛蔰虝謢護豰鄠頀餬鳠鳸鸌
hua1	华化花哗砉嘩芲華蕐錵鷨
hua2	华划滑哗豁猾骅铧还蕐劃嘩崋樺磆華螖譁釫鏵驊
hua4	话华化划画桦嬅劃婳嫿崋摦杹槬樺澅畫畵繣舙華蕐觟話諣譮
huai2	怀徊淮槐踝佪懐懷櫰瀤耲褢褱
huai4	坏孬咶壊壞蘹蘾諙
huai5	划
huan1	欢獾驩懽歓歡犿讙貛酄鴅鵍
huan2	还环寰鬟桓圜洹郇缳锾萑嬛镮澴鹮垸寏懁捖狟狥環瓛糫繯羦肒荁萈豲貆還鍰鐶闤阛雈
huan3	缓澣皖睆緩藧輐
huan4	换患幻唤宦焕痪涣浣奂擐豢漶逭鲩喚喛嚾垸奐嵈愌換梙槵渙烉煥瑍瘓瞣觨轘鯇鰀
huang1	荒慌肓谎嚝塃巟朚衁
huang2	黄皇煌惶徨璜簧凰潢蝗蟥遑隍磺癀湟篁鳇黃騜偟喤堭墴媓崲撗熿獚瑝穔艎葟趪鍠鐄锽韹餭鰉鱑鷬
huang3	晃恍谎幌奛宺怳晄榥洸滉熀皝縨詤謊鎤
huang4	晃皝愰晄皩軦
hui1	挥辉灰恢徽堕诙晖麾珲咴虺隳袆翚噕墮婎幑拻揮撝暉洃瀈烣煇琿睳禈翬褌褘詼豗輝隓顪鰴鼿
hui2	回徊蛔茴洄廻囘囬廽恛痐藱蚘蛕蜖迴逥鮰
hui3	毁悔虺會檓毀毇烠燬虫誨譭賄
hui4	会汇惠慧溃绘讳贿晦秽诲彗烩荟卉喙恚浍哕缋桧蕙蟪恵翙芔僡儶匯嘒噦噧嚖圚嬇寭廆彙彚憓暳會槥橞檜櫘殨泋滙潓潰澮濊燴獩璯瞺禬穢篲絵繐繢繪翽蔧薈襘詯詴誨諱譓譿賄鏸鐬闠阓靧韢頮颒餯饖
hun1	婚昏荤阍混惛惽敯昬棔殙涽睧睯葷閽
hun2	混魂浑馄珲堚忶棞楎渾琿繉轋顐餛餫鼲
hun4	混诨溷俒倱圂慁渾焝諢
huo1	豁劐攉锪耠嚄鍃鍯鏓
huo2	和活火佸咊秳萿鈥閄
huo3	火伙夥钬漷邩鈥
huo4	和或获货祸惑霍豁藿嚯镬蠖濩矐剨咊咟嗀嚄嚿壑奯彟彠捇掝擭旤曤楇檴沎湱瀖獲瓁癨眓矆矱硅礊禍穫耯臒艧蒦謋讗貨鑊锪雘靃韄騞鱯
ji1	其几期机基击奇激积鸡迹绩饥缉圾姬矶肌讥叽稽畸跻羁嵇唧畿齑箕屐剞玑赍犄墼芨丌咭笄乩績襀撃勣禨刏喞嗘嘰姫尐居峜嵆幾擊朞枅樍機櫅欚毄璣癘癪磯稘積竒筓簊緝羇羈耭聻萁虀蛣覉覊觭諅譏譤賫賷跡蹟躋躸銈鐖鑇鑙隮雞霙鞿韲飢饑鰿鳮鶏鷄鸄齍齎齏
ji2	及即辑级极集急籍吉疾嫉藉脊棘汲岌笈瘠诘亟楫蒺殛佶戢嵴蕺给几击圾伋亼偮卙卽叝吃堲塉姞寂嶯庴彶忣揤擊擮楖極槉橶湒漃潗濈狤礏箿級耤膌莋蓻蕀蝍螏衱襋觙踖蹐輯轚郆鈒銡鍓鏶雦雧霵革鞊鴶鶺鹡
ji3	几给己革济纪挤脊戟虮掎麂已嵴丮剞妀幾撠擠泲濟穖給蟣魕魢鱾
ji4	记系计济寄际技纪继既齐季寂祭忌剂冀妓骥蓟悸伎暨霁稷偈鲫髻觊荠跽哜鲚洎芰迹绩垍継済惎兾刉剤劑嚌坖塈墍彐彑懻斉斊旡旣曁梞檕檝檵漈濟瀱璾痵瘈癠皍瞡矂禝稩穄穊穧紀繋繫繼罽臮萕葪蔇薊薺蘎蘮蘻裚褀覬計記誋躋際霽騎驥鬾魝鮆鯚鯽鰂鰶鱀鱭鵋齌
jia1	家加佳夹嘉茄挟枷珈迦伽浃痂笳葭镓袈跏乫傢嗧夾幏拁毠泇浹犌猳縀耞腵豭貑鉫鎵鴐麚
jia2	夹颊戛荚郏恝铗袷蛱浃鴶甲唊圿埉夾戞扴挾梜浹硈筴舺莢蛺裌跲郟鉿鋏鞂鞈頬頰餄鵊
jia3	假角脚甲搅贾缴绞饺矫佼狡剿侥皎胛铰挢岬徼湫敫钾嘏瘕椵仮叚夏婽徦捁撟撹攪斚斝榎槚檞檟玾矯絞繳賈踋鉀鉸餃
jia4	价假架驾嫁稼仮価價榢賈駕
jia5	家
jian1	间坚监渐兼艰肩浅尖奸溅煎歼缄笺菅蒹搛湔缣戋犍鹣鲣鞯瑊冿囏堅姦姧孯幵廌惤戔揃椷樫櫼殱殲淺漸濺瀐瀸熞熸牋猏玪監睷碊礛箋篯籛緘縑艱菺葌蕑蕳虃譼豜豣鈃鑯間靬鞬韀韉飦餰馢騝鬋魐鰜鰹鳒鳽鵳鶼麉
jian3	简减检剪捡拣俭碱茧柬蹇謇硷睑锏枧戬谫囝裥笕翦趼詃暕倹儉堿寋弿戩挸揀撿梘検檢減湕瀽瑐瞼礆筧簡絸繭藆蠒襇襺謭譾鐗鐧鰔鹸鹻鹼
jian4	见间件建监渐健剑键荐鉴践舰箭贱溅槛谏僭涧饯毽锏楗腱牮踺剣見侟俴剱劍劎劒劔徤擶旔栫榗檻洊漸澗濺瀳珔監瞷磵礀糋糮繝繿臶艦蔪薦螹襉覵覸諌諓諫譖譼谮賎賤趝踐釰釼鋻鍳鍵鏩鐗鐧鑑鑒鑬鑳間餞鰎
jiang1	将江疆姜浆僵缰茳礓豇殭强壃將摪橿漿瓨畕畺疅繮翞葁薑螀螿韁鱂鳉
jiang3	讲奖蒋桨耩蔣奨奬槳滰獎膙講顜
jiang4	将强降酱浆虹匠犟绛洚糨彊匞將嵹弶強摾漿糡絳袶謽醤醬
jiao1	教交焦骄郊胶椒娇浇姣跤蕉礁鲛僬鹪蛟艽茭憍嘄嬌峧嶕憿澆燋穚膠膲芁茮虠蟂蟭詨鐎驕鮫鱎鴵鵁鷍鷦鷮
jiao2	嚼矫峤脚矯
jiao3	角脚搅缴绞饺矫佼狡剿侥皎挢徼湫敫铰鲛僥儌劋勦孂徺捁撟撹攪敽晈暞曒湬漅灚烄煍璬皦矯筊絞繳腳臫蟜譑賋踋較鉸餃
jiao4	教觉校叫较轿嚼窖酵噍峤徼醮呌嘂嘦噭嶠挍敎斠滘漖潐爝珓皭窌藠覐覚覺訆譥較轎釂
jie1	接结节街阶皆揭楷嗟秸疖喈湝偕啑堦幯掲擑椄癤稭節結腉菨蝔階鶛
jie2	结节杰捷截洁劫竭睫桔拮孑诘桀碣偈颉讦婕羯鲒解結刼倢劼絜偼傑刦刧卩卪喼岊崨嵑嵥巀揤搩擳昅楬楶榤櫛櫭洯滐潔瀄犵節緁緳脻莭蓵蜐蠘蠞蠽衱袺訐詰誱趌踕迼鉣鍻鐑頡騔鮚
jie3	解姐媎觧飷
jie4	界解价介借戒届藉诫芥疥蚧骱堺丯価吤唶屆岕庎徣悈楐犗玠琾畍痎砎祴紒繲艥褯觧誡躤鎅魀
jie5	家价姐
jin1	今金禁津斤筋巾襟矜衿紧兓埐嶜惍浸珒琎瑧紟荕菳觔釒钅鹶黅
jin3	尽仅紧谨锦瑾馑卺廑堇槿进緊侭僅儘厪墐巹慬漌盡菫覲謹錦饉
jin4	进近尽仅禁劲晋浸靳缙烬噤觐荩赆妗琎溍搢伒侭僅僸儘凚勁嚍嫤嬧寖晉歏殣浕濅濜燼瑨璡璶瘽盡祲縉肵蓳藎覲賮贐進齽
jing1	经京精惊睛晶荆兢鲸泾旌茎腈菁粳鼱経筋亰坕坙婛巠旍涇猄秔稉經聙荊莖驚鯨鵛鶁鶄麖麠黥
jing3	警景井颈憬阱儆刭肼璟丼剄宑憼暻汬烴燛璥穽蟼頚頸
jing4	经境竟静敬镜劲竞净径靖痉迳胫弪婧獍靓俓倞凈凊劤勁妌婙弳徑擏曔桱梷浄淨濪瀞痙竧竫競竸経經脛葝誩逕鏡靚靜
jiong1	扃冂冋坰埛蘏蘔駉駫
jiong3	窘炯迥炅囧颎冏侰僒幜泂澃烱煚煛熲皛絅綗褧逈顈
jiu1	究纠揪鸠赳啾阄鬏丩勼揂揫朻樛湫牞糺糾萛觓轇鬮鳩
jiu3	九酒久韭灸玖赳乆奺糾紤舏镹韮
jiu4	就旧救疚舅咎臼鹫僦厩桕柩鷲匓匛匶媨廄廏廐慦捄柾究舊鯦麔齨
ju1	车据且居俱拘驹鞠锯趄掬疽裾苴椐锔狙琚雎鞫蜛沮娵倶凥刟崌抅拠揟據斪毱泃涺痀眗罝腒艍葅蛆諊跔踙車輋鋦鋸駒鮈鯺鴡鶋
ju2	局菊桔橘锔举跼鵴焗侷匊婅巈挶掬梮椈毩泦淗湨犑狊箤粷蘜趜踘蹫躹輂郹鄓鋦陱鞠鞫駶驧鴂鵙鶪鼳
ju3	举柜矩咀沮踽龃榉莒枸榘弆挙擧椇楀櫃櫸欅窼竘筥舉蒟蝺袓跙齟
ju4	据句具剧巨聚拒距俱惧沮瞿锯炬趄飓踞遽倨钜犋屦榘窭讵醵苣佢倶劇勮埧埾壉姖寠屨岠怇怚愳懼拠據昛檋歫洰澽焣秬窶簴粔絇耟虡蚷詎貗足躆邭鉅鋸鐻颶駏鮔
juan1	捐圈娟鹃涓镌蠲剶勬圏姢朘脧裐身鎸鐫鵑
juan3	卷锩埢巻捲臇菤錈
juan4	圈卷俊倦眷隽绢狷桊鄄劵巻儁勌圏奆帣悁慻淃獧瓹睊睠絹罥羂腃雋韏飬鬳
jue1	嗟撅噘
jue2	觉绝决角脚嚼掘诀崛爵抉倔獗厥蹶攫谲矍孓橛噱珏桷劂爝镢蕨觖瑴泬玦駃亅傕僪刔堀孒屩屫崫嶥弡彏憰戄挗捔撧斍橜欔欮殌氒決焆焳熦爑爴玨疦瘚矡砄穱絕絶臄芵蕝蚗蟨蟩覐覚覺觼訣譎谻赽趹踋蹷躩逫鈌鐍鐝钁鱊鴃鷢龣
jue3	蹶
jue4	倔憠
jun1	军均君钧筠龟菌皲麇莙亀囷姰桾汮皸皹碅箟蚐袀覠軍鈞銁銞頵鮶鲪麏麕龜
jun4	俊峻隽菌郡骏竣捃浚珺濬畯埈晙儁呁寯懏捘攈攟焌箘箟葰蔨蕈陖雋餕馂駿鵘
ka1	咖喀咔哈鉲
ka3	卡咯咔佧胩咳
kai1	开揩锎開侅奒鐦
kai3	慨凯铠楷恺蒈剀垲锴闿凱剴嘅塏愷暟豈輆鍇鎧闓颽
kai4	忾勓咳壒愒愾慨欬炌炏烗
kan1	看刊堪勘龛戡嵁栞龕
kan3	侃砍坎槛阚莰偘冚凵埳塪崁惂檻欿歁歞繿輡轗闞顑
kan4	看嵌瞰阚磡勘墈矙竷衎闞鬫
kang1	康慷糠闶嫝忼槺漮穅粇躿鏮閌鱇
kang2	扛
kang4	抗炕亢伉闶钪匟囥犺砊邟鈧閌
kao1	尻髛鷱
kao3	考烤拷栲丂攷槀洘熌燺稁薧鮳
kao4	靠铐犒銬鲓
ke1	科颗柯呵棵苛磕坷嗑瞌轲稞疴蝌钶窠颏珂髁榼匼牁刻峇嵙樖犐砢礚簻胢萪薖軻醘鈳頦顆
ke2	咳壳颏可榼殻殼頦
ke3	可渴坷轲岢堁嶱敤渇炣礍軻閜鲄
ke4	克客刻课恪嗑溘骒缂氪锞蚵科可把兙兡剋勀勊厒喀垎娔尅愙揢搕榼碦緙課騍
ken3	肯恳啃垦龈墾懇肎肻豤錹齗齦
ken4	裉掯珢硍褃
keng1	坑吭铿阬劥坈妔娙挳摼牼硁硜硻銵鍞鏗
kong1	空倥崆箜埪悾涳硿錓鵼
kong3	恐孔倥
kong4	空控鞚
kou1	抠芤眍q剾彄摳瞘袧鏂
kou3	口劶
kou4	扣寇叩蔻筘冦宼怐敂滱瞉窛簆蔲釦鷇
ku1	哭枯窟骷刳堀轱圐扝桍橭矻胐跍郀顝
ku3	苦楛
ku4	库裤酷喾绔俈嚳庫瘔秙絝袴褲趶
kua1	夸侉咵姱晇荂誇
kua3	垮侉銙
kua4	跨挎胯骻
kuai3	蒯擓
kuai4	会快块筷脍哙侩狯浍郐桧儈凷噲塊墤會檜欳澮獪膾鄶駃鬠鱠鲙
kuan1	宽髋寛寬臗髖
kuan3	款窾梡欵歀
kuang1	框筐匡哐诓劻匩恇洭硄筺誆軭邼
kuang2	狂诳抂誑鵟
kuang3	夼俇儣
kuang4	况矿框旷眶邝圹纩贶況兤卝壙岲彉懭昿曂曠爌眖砿礦絋絖纊貺躀鄺鉱鑛黋
kui1	亏窥盔岿悝刲噅巋窺茥藈蘬虧鍷闚鞹
kui2	魁睽逵葵奎馗夔喹隗暌揆蝰戣晆楏楑櫆湀犪聧蘷躨鄈鍨頯騤骙
kui3	傀跬峞煃蹞頍
kui4	愧溃馈匮喟聩篑蒉愦匱嘳媿尯憒撌椢槶樻潰瞆瞶硊簀簣籄聭聵蔮蕢鐀鑎餽饋騩
kun1	昆坤鲲锟醌琨髡焜崐堃婫崑惃晜猑瑻菎蜫裈褌貇錕騉髠髨鯤鵾鹍
kun3	捆悃阃壸壼梱硱祵稇稛綑裍閫閸齫
kun4	困涃睏
kuo4	括适阔扩廓栝蛞姡彍拡挄擴桰漷濶籗適闊霩鞟鞹
la1	拉啦喇垃邋嚹柆翋菈
la2	拉喇旯砬邋剌揦磖
la3	拉喇藞
la4	落拉辣腊蜡剌瘌揧攋楋溂瓎臈臘蝋蝲蠟辢鑞镴鬎鯻鵣
la5	蓝啦藍鞡
lai2	来莱徕涞崃铼來出俫倈唻婡崍庲徠梾棶淶琜筙箂萊郲錸騋鯠鶆麳
lai4	赖睐癞籁赉濑瀬勑娕櫴瀨癩睞籟藾賚賴頼顂
lan2	兰蓝栏拦篮澜婪岚斓阑褴镧谰儖厱囒嵐幱懢攔斕欄欗瀾灆灡燣燷璼礷籃籣糷葻藍蘫蘭襕襤襴譋讕躝鑭钄闌韊
lan3	懒览揽榄缆漤罱懶壈嬾孄孏擥攬欖浨灠爦纜覧覽醂顲
lan4	烂滥缆壏濫燗爁爛爤爫瓓纜鑭
lang1	啷
lang2	狼郎廊琅螂榔锒稂阆俍勆嫏桹欴瑯筤艆莨蓈蓢蜋躴郒郞鋃閬
lang3	朗塱峎斏朖朤樃烺焃硠誏閬
lang4	浪郎莨蒗阆崀埌郒閬
lao1	捞撈
lao2	劳牢唠崂铹痨醪老労勞哰嘮嶗憥浶澇癆磱窂簩蟧醦鐒
lao3	老姥佬潦栳铑咾恅橑狫荖轑銠
lao4	落络唠烙酪涝耢僗勞嘮嫪憦橯澇絡耮軂髝
le1	肋
le4	乐勒仂叻泐鳓捋楽哷埒忇扐樂氻玏砳竻簕肋艻阞頱鰳
le5	了餎饹
lei1	勒擂
lei2	累雷擂羸镭嫘缧檑蕾罍壨櫑欙瓃畾礌縲纍纝蠝轠鐳鑘靁鼺
lei3	累蕾垒磊儡诔耒傫厽塁壘樏櫐櫑洡灅瘣癗磥礧礨絫蕌藟蘲蘽虆誄讄鑸頛鸓
lei4	类泪累擂肋酹涙儽攂淚禷纇蘱銇錑頪類颣
lei5	嘞
leng1	棱
leng2	楞棱塄冷倰崚稜蔆薐
leng3	冷
leng4	愣堎楞踜
li1	哩
li2	离丽黎璃漓狸梨篱犁厘罹藜骊蜊黧缡喱鹂嫠蠡鲡蓠理礼離嚟杝刕剓剺劙囄孋孷廲悡攡梩梸棃樆氂漦灕犂犛猍瓈睝穲籬粍粚糎縭艃菞蔾蘺蟍蟸褵謧貍邌醨釐鋫錅鏫鑗騹驪鯬鱺鵹鸝麗麶黐
li3	里理李礼哩鲤俚逦娌悝澧锂蠡醴鳢裡豊兣峛峢欚浬禮粴蟸裏邐鋰鯉鱧
li4	力利立历例丽励厉莉笠粒俐栗隶吏沥雳莅戾俪砺痢郦詈荔枥呖唳猁溧砾栎轹傈坜苈疠疬蛎鬲篥粝跞暦涖歴瑮儮儷凓勵厤厯厲唎嚦囇塛壢娳婯屴岦峲巁悧悷慄戻搮攦攭斄曆曞朸栛栵棙檪櫟櫪欐歷沴浰濿瀝爄爏犡珕琍瓅瓑瓥癘癧皪盭矋砅砬磿礪礫礰禲秝筣糲綟纅脷苙茘蒞藓藶蘚蚸蛠蜧蝷蠇蠣蠫觻讈赲躒轢轣酈釙鉝隷隸雴靂靋鬁鱱鱳鳨鴗鷅鷑麗麜
li5	璃哩莉里
lia3	俩倆
lian2	联连怜莲廉帘涟镰裢濂臁奁蠊鲢亷劆匲匳嗹噒奩奱嫾嬚慩憐梿槤櫣溓漣濓熑燫璉磏稴簾籢籨縺翴聨聫聮聯蓮薕螊褳覝謰譧蹥連鎌鐮鬑鰱
lian3	脸敛琏蔹裣僆摙斂璉羷臉蘞襝鄻
lian4	练恋炼链殓楝潋鍊僆堜媡戀斂歛殮湅澰澵瀲煉瑓練纞萰薟蘝蘞襝錬鏈鰊
liang2	量良梁凉粮粱踉莨椋墚两樑涼簗糧綡輬辌駺
liang3	两俩魉両倆兩唡啢掚緉脼蜽裲魎
liang4	量亮辆凉谅晾踉靓倞哴喨悢涼湸諒輌輛鍄靚
liao1	撩撂蹽
liao2	聊疗辽僚寥撩撂缭寮燎嘹獠鹩了潦憀嫽尞屪嵺嶚嶛廫摎敹漻熮璙療窷簝繚膋膫豂賿蹘遼鐐镽顟飂飉髎鷚鷯
liao3	了潦燎蓼钌尞憭暸瞭蟟鄝釕
liao4	了料廖镣撩撂尥钌瞭尦炓燎爒窲蟉釕鐐
lie1	咧
lie3	裂咧
lie4	列烈裂劣猎趔冽洌捩埒躐鬣儠劽埓姴巤挒擸浖煭犣猟獵睙聗脟茢蛚蛶迾颲鬛鮤鱲鴷
lie5	咧
lin2	林临秘邻琳淋霖麟鳞磷嶙辚粼遴啉瞵璘僯厸壣惏斴晽暽潾瀶燐獜甐疄痳矝碄箖粦繗罧翷臨蹸轔轥鄰鏻隣驎鱗麐
lin3	凛懔檩廪亃凜廩懍撛檁澟癛癝綝菻
lin4	淋吝躏赁蔺膦恡悋橉焛藺賃躙躪閵
lin1	拎
ling2	令灵零龄凌玲铃陵伶聆囹棱菱苓翎棂瓴绫酃泠羚蛉柃鲮领岭澪鸰夌琌霊〇刢呬坽堎姈婈孁怜掕昤朎櫺欞淩燯爧狑皊睖砱碐祾秢竛笭紷綾舲蕶蘦衑裬詅跉軨輘醽鈴錂閝霛霝靈駖魿鯪鴒鹷麢齡齢龗
ling3	领令岭岺嶺彾袊阾領
ling4	令另呤炩
liu1	溜熘澑
liu2	留流刘瘤榴浏硫琉遛馏镏旒骝鎏柳鏐镠飗劉嚠媹嬼嵧懰旈橊沠瀏瑠瑬璢畄畱疁癅蒥蓅藰裗鎦鐂飀飅餾駠駵騮驑鰡鶹鷎鹠麍
liu3	柳绺锍铆栁桺橮珋綹罶羀鉚鋶飹
liu4	六陆溜碌遛馏镏鹨坴塯廇澑熘畂磂翏蹓鎦鐂陸雡霤餾鬸鷚
lo5	咯
long1	隆霳
long2	龙隆笼胧咙聋珑窿茏栊泷砻癃眬儱嚨屸嶐巃巄昽曨朧槞櫳湰滝漋瀧爖瓏矓礱礲竜篭籠聾蘢蠪蠬襱豅躘鏧鑨霳靇鸗龍龒龓
long3	笼拢垄陇垅壟壠攏篭籠隴
long4	弄哢徿挊挵梇硦衖贚
lou1	搂摟
lou2	楼喽偻娄髅蝼蒌耧僂剅嘍婁廔樓溇漊熡瞜耬艛蔞螻謱軁遱鞻髏鷜
lou3	搂篓嵝塿嶁摟甊簍
lou4	露陋漏镂瘘屚瘺瘻鏤鐚
lou5	喽嘍
lu1	噜撸嚕擼
lu2	卢炉庐芦颅泸轳鲈垆胪鸬舻栌髗嚧圥壚廬攎曥枦櫨瀘爐獹玈瓐盧矑籚纑罏臚舮艫蘆蠦轤鈩鑪顱魲鱸鸕黸
lu3	鲁芦卤虏掳橹镥撸塷擄樐櫓氇氌滷澛瀂硵磠艣艪蓾蘆虜鏀鐪鑥魯鹵
lu4	六路陆录露绿鹿碌禄辘麓赂漉戮簏鹭潞璐辂渌蓼逯録箓侓僇剹勎勠垏塶娽峍廘彔摝椂樚淕淥熝琭甪盝盠睩硉磟祿稑穋簬簶籙粶膔菉蔍蕗虂螰觮賂趢踛蹗輅轆醁錄錴鏕鏴陸騄騼鯥鵦鵱鷺
lu5	轳氇噜
lv3	旅履屡侣缕吕捋铝偻褛膂稆侶僂儢呂婁寽屢挔捛梠漊祣穞穭絽縷膐褸郘鋁
lv4	律绿率虑滤氯緑嵂勴卛慮濾爉綠膟菉葎葏鑢
lv5	驴榈闾率
luan2	峦挛孪栾銮滦鸾娈脔圝圞孌孿巒攣曫欒灓灤癴癵羉臠虊鑾鵉鸞
luan3	卵
luan4	乱亂薍釠
lue3	掠
lue4	略掠锊
lun1	抡掄
lun2	论轮伦沦仑抡囵纶侖倫嗧圇婨崘崙惀掄棆淪碖綸腀菕蜦論踚輪錀陯鯩
lun4	论溣論
luo1	落罗捋啰囉寽攞羅
luo2	罗逻萝螺锣箩骡猡椤脶镙儸剆囉欏玀籮羅腡蔂蘿覙覶覼邏鏍鑼饠騾驘鸁
luo3	裸倮蠃瘰曪癳臝蓏躶鎯
luo4	落络洛骆咯摞烙珞泺漯荦硌雒嗠峈濼濽犖笿絡纙跞酪韷駱鮥鴼鵅
luo5	罗
m2	呒嘸
ma1	妈麻摩抹蚂嬷媽嬤擵蔴螞
ma2	吗麻蟆马玛嘛犘痲蔴蟇麼
ma3	马吗码玛蚂犸嗎嘜溤獁瑪碼螞鎷馬鰢鷌
ma4	骂蚂唛杩犸傌嘜帓榪睰祃禡罵螞閁駡
ma5	么吗嘛妈嗎蟆
mai2	埋霾薶
mai3	买荬買嘪蕒鷶
mai4	卖麦迈脉劢売佅勱眿脈蝐賣邁霡麥
man1	颟嫚顢
man2	埋蛮馒瞒蔓谩鳗鞔满悗慲摱槾漫璊瞞蠻謾蹣顢饅鬗鬘鰻
man3	满螨満屘滿矕蟎襔鏋
man4	慢漫曼蔓谩墁幔缦熳镘僈嫚槾澫澷獌縵蔄謾鏝
mang2	忙茫盲芒氓邙硭吂哤奀娏尨恾悂杗杧浝牤牻狵痝盳笀蘉蛖釯鋩铓駹鼆
mang3	莽蟒漭壾庬汒硥茻莾蠎
mao1	猫貓
mao2	毛猫矛茅髦锚牦旄蝥蟊茆兞堥媌嫹枆渵罞覒軞酕錨髳鶜
mao3	卯铆峁泖昴冇夘戼笷茆鉚
mao4	冒贸帽貌茂耄瑁懋袤瞀貿楙鄮冃冐媢旄暓柕毷皃眊瞐艒芼萺鄚
me5	么麽点麼
mei2	没眉梅媒枚煤霉玫糜酶莓嵋湄楣猸镅鹛美每沒呅堳塺徾攗栂楳槑湈珻瑂睂禖篃脄脢腜苺葿郿鋂鎇鶥黴
mei3	美每镁浼凂媄媺嬍嵄挴毎渼燘鎂黣
mei4	妹魅昧谜媚寐袂眛沬煝瑁痗睸祙蝞謎跊韎鬽
men1	闷们门悶
men2	门扪钔们們捫樠穈菛虋鍆門閅
men4	闷懑焖悶懣燜
men5	们們
meng1	蒙
meng2	蒙盟朦氓萌檬瞢甍礞虻艨濛儚冡幪曚橗氋甿矇矒莔萠蕄蝱鄳鄸雺靀饛鯍鸏鹲
meng3	蒙猛勐懵蠓蜢锰艋懜懞獴瓾錳鯭
meng4	梦孟夢夣溕霥霿
mi1	眯咪瞇
mi2	迷弥谜靡糜醚麋猕祢縻蘼米冞壐彌戂擟攠檷瀰爢獼瓕眯禰籋罙蒾蘪詸謎醾醿釄镾鸍麊麛
mi3	米眯靡弭敉脒芈迷洣侎哶孊沵渳濔灖眫葞蔝銤
mi4	密秘觅蜜谧泌汨宓幂嘧祕糸冖冪塓宻峚幎幦榓樒櫁淧淿滵漞濗簚糹纟羃蔤藌蠠覓覔謐鼏
mian2	棉眠绵婂媔嬵宀檰櫋矈矊矏綿緜臱芇蝒
mian3	免缅勉腼冕娩渑湎沔眄黾丏俛偭勔喕愐汅澠絻緬靦鮸麫黽
mian4	面眄粫糆靣麪麵麺
miao1	喵
miao2	描苗瞄鹋緢鱙鶓
miao3	秒渺藐缈淼杪邈眇杳篎緲
miao4	妙庙缪庿廟玅竗繆
mie1	乜咩吀孭羋
mie4	灭蔑篾蠛幭懱搣櫗滅瀎礣薎衉衊覕鑖鱴鴓
min2	民珉岷缗玟苠旻旼崏忞忟怋捪暋琘瑉痻盿砇碈緍緡罠鈱錉鍲閺
min3	敏悯闽泯皿抿闵愍黾鳘渑湣僶冺刡勄慜憫敃敯暋潣澠笢簢閔閖閩鰵黽
ming2	名明鸣盟铭冥茗溟瞑暝螟洺佲嫇朙榠熐猽眀蓂覭詺鄍酩銘鳴
ming3	酩凕姳慏眳
ming4	命暝
miu4	谬缪繆謬
mo1	摸
mo2	无模麽磨摸摩魔膜蘑馍摹谟謩劘嚤嚩嚰嫫擵橅無糢藦謨饃饝髍
mo3	抹懡抺
mo4	莫陌磨末默沫漠寞没墨膜茉抹脉秣蓦瘼靺殁万冐冒劰嗼嘜嘿嚜圽塻妺嫼帞慔昩暯枺歾歿沒湐爅狢獏皌眜眽瞙砞礳粖縸纆耱脈莈萬藦蛨蟔衇袹覛謩貃貉貊貘銆鏌镆霢鞆驀鬕魩黙
mo5	寞沫庅麼
mu3	拇牡亩姆母姥娒峔牳畆畒畝畞畮砪胟鉧
mu4	墓暮幕募慕木目睦牧穆沐牟钼苜仫坶幙恈楘毣炑莯蚞鉬雮霂鞪鶩
na2	拿哪嗱拏挐誽鎿镎
na3	哪雫乸那
na4	呐钠那娜纳衲么捺吶呢妠抐笝納肭蒳袦訥豽軜鈉魶
na5	呐哪
nai3	氖乃奶妳廼哪奈嬭氝疓艿迺釢
nai4	耐奈褦萘鼐柰佴倷渿螚錼
nan2	南男难楠喃柟侽奻娚暔枏枬畘莮萳諵難
nan4	难婻難
nang2	囊嚢欜饢馕
nao1	孬峱
nao2	挠铙猱伮努呶夒峱嶩巎巙怓憹撓橈獶獿硇繷虁蛲蟯詉譊鐃髐
nao3	脑恼瑙垴匘堖悩惱碯脳腦
nao4	闹淖臑閙鬧
ne2	哪
ne5	呢吶呐
nei3	馁哪脮腇餒鮾鯘
nei4	内內那氝
nen4	嫩恁嫰
neng2	能儜薴
ni1	妮妞姄
ni2	霓倪泥尼呢铌坭埿婗屔怩淣狋狔猊秜籾臡蜺觬貎跜輗郳鈮鉨鯓鯢鲵鶂麑齯
ni3	拟你旎妳伱儗儞孴抳擬昵柅檷祢禰苨薿蚭譺隬馜
ni4	匿腻逆溺昵泥伲埿堄嫟嬺尿屰惄慝暱氼睨縌胒膩迡鷁鷊
nian1	蔫拈
nian2	年粘黏拈鲶鲇姩秊秥鮎鯰
nian3	碾撵捻辗辇拈撚攆涊簐跈蹨躎輦鯰齳
nian4	念廿卄唸埝淰艌酿鼰齞
niang2	娘嬢孃酿
niang4	酿醸釀
niao3	鸟袅嬲茑褭嫋嫐嬝樢蔦裊鳥
niao4	尿溺脲
nie1	捏㖏惗揑踗鈢鑈
nie4	聂孽啮镊镍涅蘖蹑㖏乜喦嗫噛嚙囁囓圼孼嵲巕帇敜枿棿櫱湼疌痆篞糱糵聶臬臲菍蘗蠥踂躡錜鎳鑷钀闑陧隉顳颞齧齩
nin2	您囜恁
ning2	柠狞凝宁拧咛甯嚀嬣寍寕寗寜寧擰檸獰聍聹苎苧鑏鬡鸋
ning3	拧擰橣矃
ning4	拧泞宁佞侫寧濘
niu2	牛
niu3	扭钮纽忸杻炄狃紐莥鈕靵
niu4	拗
nong1	浓脓
nong2	浓农侬脓醲哝儂噥檂欁濃癑禯秾穠膿襛農辳鬞齈
nong4	弄挊挵
nu2	奴孥驽笯蒘駑
nu3	努弩伮砮胬
nu4	怒搙
nv3	女钕籹釹
nuan3	暖渜煖煗餪
nue4	虐疟
nuo2	挪傩娜郍儺捼梛
nuo4	懦糯诺喏愞懧挼掿搦搻榒稬穤糑糥諾蹃逽鍩锘
o5	哦
ou1	欧鸥殴瓯呕歐区區嘔塸慪櫙毆沤漚熰甌蓲謳讴鴎鷗
ou3	藕呕偶耦吘嘔腢蕅
ou4	沤呕嘔怄慪漚
pa1	啪趴爬葩妑扒派皅舥蚆
pa2	爬琶杷扒掱潖筢耙跁鈀钯
pa4	帕怕帊絈袙
pa5	琶杷
pai1	拍
pai2	排牌徘俳棑篺簰簲輫
pai4	湃派哌汖蒎鎃
pan1	攀潘番扳畨眅砙
pan2	盘胖磐槃蟠爿盤鞶磻丬噃媻幋搫瀊縏般蒰跘踫蹒蹣鎜
pan4	盼畔判叛泮袢拚冸沜溿炍牉襻詊鑻頄頖
pang1	乓雱滂磅胮膀膖
pang2	庞旁螃彷膀磅厖逄厐嫎尨庬徬篣舽蒡雱霶騯鰟鳑龎龐
pang3	耪嗙覫
pang4	胖炐肨
pao1	抛泡拋炮脬
pao2	咆袍刨庖龅炮匏垉炰爮狍瓟跑軳鞄麅
pao3	跑
pao4	炮泡砲疱奅皰礟礮靤髱麭
pei1	呸胚醅坏垺妚娝岯柸肧衃
pei2	培裴赔陪锫毰荖裵賠錇阫陫
pei4	配佩沛珮霈辔伂姵帔斾旆浿翇苝轡馷
pen1	喷喯噴歕
pen2	盆湓瓫葐
peng1	砰抨烹澎嘭怦匉恲梈漰硑磞軯閛駍
peng2	澎彭蓬棚硼篷膨朋鹏芃捧倗傰埄堋塜塳憉挷搒椖樥淜痭稝竼纄蟚蟛輣錋鑝韸韼驡髼鬅鬔鵬
peng3	捧淎皏
peng4	碰堋掽椪
peng5	篷蓬
pi1	坯砒霹批披劈丕邳噼纰铍伾匹坏壊壞怌怶憵抷旇炋狉狓磇礕秛秠紕翍耚被豾辟釽鈹鉟銔闢駓髬鴄
pi2	皮琵毗啤脾疲枇铍貔郫裨芘毘鼙埤壀朇椑毞焷犤猈玭笓紕罴罷羆肶腗膍藣蚍蚽蜱螷蠯豼鈚鈹錍阰陂陴隦魮魾鮍鲏
pi3	匹痞癖否嚭疋劈仳吡噽圮崥庀擗脴苉諀
pi4	僻屁譬辟媲淠嚊嫓揊渒潎澼甓癖睤睥礔闢髲鷿鸊
pian1	篇偏片翩扁囨媥犏萹貵頨鶣
pian2	骈便楩緶缏胼腁諚諞賆蹁駢騈骿
pian4	片骗遍騗騙
piao1	飘漂剽缥僄勡慓旚縹翲薸螵飃飄魒
piao2	漂瓢朴嫖淲竂闝
piao3	瞟漂醥殍犥皫縹缥莩鷅
piao4	漂票嫖骠剽嘌彯徱篻蔈顠驃
pie1	撇瞥瘪撆暼氕
pie3	撇瞥丿苤鐅
pin1	拼拚姘涄礗
pin2	频贫品嫔颦嚬娦嬪瀕矉苹薲蘋貧頻顰
pin3	品榀
pin4	聘牝
ping1	乒娉俜焩砯聠覮頩
ping2	坪苹萍平凭瓶评屏缾冯凴呯屛帡帲幈慿憑枰泙洴炾玶甁甹竮箳簈胓艵荓蓱蘋蚲蛢評軿輧郱馮鮃鲆
po1	坡泼颇泊攴攵朴波泺溌潑癹翍酦醗鏺钋陂
po2	婆鄱陂皤嘙櫇繁蔢
po3	颇叵剖尀笸鉕钷頗
po4	破魄迫粕朴珀岶廹樸泊洦炇烞砶蒪醱
pou1	剖吥
pu1	扑铺仆噗僕抪撲擈潽痡瞨舗鋪陠
pu2	仆莆葡菩蒲谱濮璞脯匍酺僕墣朴樸穙箁纀菐蒱襆襥蹼轐鏷镤
pu3	普谱埔朴圃浦溥蹼圑堡暜樸檏氆烳誧諩譜鐠镨
pu4	铺曝瀑暴堡舖舗鋪鮬
qi1	期七欺栖漆妻凄柒年沏戚桼蹊萋嘁倛僛咠唭娸徛悊悽慼慽捿攲朞桤棲榿槭欹淒溪磩紪緀緝缉諆谿踦郪霋顣魌鶈鸂
qi2	其旗琪骑骐棋歧岐琦齐奇祁祺麒起祈淇芪锜脐綦鳍圻蕲崎耆畦俟祇埼鬐亓亝剘墘岓嵜帺愭懠掑斉斊旂期枝棊檱櫀濝猉玂璂畁疷碁碕禥稘竒竢簱籏粸綨纃翗臍艩荠萁萕薺藄蘄蚑蚔蚚蛴蜝蜞蠐衹跂踑軝迉鄿釮錡錤靔頎颀騎騏鬿鮨鯕鰭鲯鵸鶀麡齊
qi3	起讫启企岂祈乞绮杞泣芑稽屺玘棨呇唘啓啔啟婍敧晵槣盀綮綺芞裿諬豈邔闙
qi4	弃气器汽戚泣砌契缉迄憩気碶葺炁碛氣亟企呮噐夡妻忔愒憇摖斉斊暣栔棄槭欫汔湆湇焏甈盵矵磜磧礘綥緝蟿訖諿讫鏚鼜齐
qia1	掐伽葜袷
qia3	卡跒酠
qia4	恰洽髂圶帢愘殎
qian1	千签牵迁谦铅骞悭芊愆阡仟岍扦佥搴褰钎僉儙兛圱圲奷婜嵌慳拪掔撁攐攑攓杄檶櫏欦汘汧牽竏竓箞簽籖籤粁羥臤蚈諐謙譣谸遷釺鉛鐱韆顅顩騫鬜鬝鵮鹐麉
qian2	前钱潜乾虔钳掮黔荨钤犍箝鬈干乹仱偂姏媊岒忴扲拑揵榩歬漧潛濳灊燂瓩葥蕁蚙軡鈐鉗銭錢騚鬵鰬鳹黚
qian3	浅遣谴缱肷嵰槏淺繾膁蜸譴
qian4	欠歉纤嵌倩堑茜芡慊椠蒨傔刋嗛塹壍悓棈槧皘篏篟綪縴蔳輤
qiang1	将枪抢腔呛锵跄羌戕戗镪蜣锖傹嗆將嶈戧搶斨椌槍溬牄猐玱琷瑲矼篬羗羫謒蹌蹡錆鎗鏘鏹鑓
qiang2	强墙蔷樯嫱丬墻嬙廧弜強彊檣漒爿牆艢蔃薔蘠軖
qiang3	强抢襁镪羟傸勥墏弜強搶磢繈繦羥鏹
qiang4	呛跄炝戗唴嗆戧熗羻蹌
qiao1	悄敲雀锹跷橇缲硗劁骹勪塙墝墽嵪幧磽繑繰趬蹺蹻郻鄡鍫鍬鏒鐰頝髜
qiao2	桥乔侨瞧翘蕉憔樵峤谯荞鞒硚僑喬嘺嫶嶠嶣敿槗橋燆癄礄簥翹蕎藮譙趫鐈鞽顦
qiao3	悄巧雀愀釥鵲
qiao4	翘俏窍壳峭撬鞘诮谯僺帩撽殻殼竅翹誚譙躈陗韒髚
qie1	切
qie3	且
qie4	切窃怯趄妾砌惬锲挈郄箧慊匧契悏愜朅洯淁穕竊笡篋藒蛪踥鍥鯜
qin1	亲钦侵衾骎親儬媇寴嵚嶔欽瀙綅誛駸鮼
qin2	琴秦勤芹擒矜覃禽噙廑溱檎锓嗪芩螓厪嫀庈懃懄捦斳澿珡琹耹肣菦蠄赺鈙雂靲鵭
qin3	寝坅寑寢昑曋螼赾鋟锓顉
qin4	沁揿吣吢唚抋搇撳菣
qing1	青清轻倾卿氢蜻圊鲭靑傾啨寈氫淸狅軽輕郬錆锖頃鯖
qing2	情晴擎氰檠黥勍傾剠夝暒樈殑甠
qing3	请顷謦苘庼廎檾綮請頃
qing4	亲庆罄磬箐綮凊慶掅殸汫漀碃磘罊親謦鑋靘
qiong2	穷琼穹茕邛蛩筇跫銎儝卭嬛宆惸桏棾橩焭煢璚瓊睘瞏窮竆笻蒆藑藭赹輁
qiu1	秋邱丘龟蚯鳅楸湫萩囚丠亀偢坵媝恘秌穐篍緧蓲蝵蟗蠤趥鞦鞧鰌鰍鱃鶖鹙龜龝
qiu2	求球仇囚酋裘虬俅遒赇泅逑犰蝤巯鼽僋厹叴崷巰扏朹梂殏毬汓浗渞煪玌璆皳盚紌絿肍脙苬莍虯蛷觩訄訅賕逎醔釚銶鮂鯄鰽
qiu3	糗搝
qu1	区曲屈趋驱躯觑岖蛐祛蛆麴诎黢麹駆佉伹凵匤區呿坥岨岴嶇憈抾敺焌瞿砠筁粬紶胠袪覰覷詘誳趨軀镼阹駈驅髷魼鰸鱋鶌麯
qu2	渠瞿衢癯劬璩氍朐磲鸲蕖蠼蘧取佢鼩匷忂懅戵斪欋淭灈玃璖籧翑翵胊臞菃葋螶蟝蠷豦貜躣軥鑺鴝鸜麴
qu3	取曲娶龋苣浀竬筁紶詓麯齲
qu4	去趣觑阒刞厺娶漆耝覰覷覻閴闃麮鼁
qu5	戌曲去趣
quan1	圈悛圏弮惓棬絟
quan2	全权泉拳诠颧蜷荃铨痊醛辁筌鬈權佺権卷啳姾婘孉峑巏恮搼洤湶灥牷犈犬瑔硂縓葲蠸觠詮跧踡輇銓顴駩騡鰁鳈齤
quan3	犬绻畎呟圈汱犭琄甽綣虇
quan4	劝券勧勸烇牶絭
que1	缺阙炔缼蒛闕
que2	瘸雀
que4	却确雀榷鹊阕阙悫卻埆墧崅怯恪愨慤搉殼毃灍燩皵硞碏確碻礐礭趞闋闕魥鵲
qun1	逡夋峮踆
qun2	群裙麇羣宭帬裠麏麕
ran2	然燃髯蚺染嘫繎肰蚒蚦蛅衻袇袡髥
ran3	染冉苒冄呥姌媣嫨橪珃髯
rang1	嚷
rang2	瓤禳穰勷穣儴攘瀼獽蘘蠰躟鬤
rang3	嚷攘壤禳壌爙
rang4	让懹瀼譲讓
rao2	饶娆桡荛嬈橈苚蕘蟯襓饒
rao3	扰绕娆嬈擾繞
rao4	绕繞遶隢
re3	若惹喏
re4	热渃熱
ren2	人任仁壬客亻忈忎朲秂紝芢鈓銋魜鴹
ren3	忍稔荏栠栣棯秹腍荵
ren4	任认韧刃纫饪仞葚妊轫衽恁赁仭刄姙屻杒梕牣牨紉絍纴肕袵訒認讱賃軔軠靫靭靱靹韌飪餁鵀
ren5	人
reng1	扔
reng2	仍礽辸陾
ri4	日囸氜衵鈤馹驲
rong2	容荣融蓉溶绒熔榕戎嵘茸狨肜蝾镕栄媶嵤嶸曧榮榵毧瀜烿爃瑢穁絨縙羢茙荗螎蠑褣鎔鎹駥髶鰫鷛
rong3	冗傇宂搑氄茸軵
rou2	柔揉蹂糅鞣鍒媃楺沑渘瑈瓇禸腬葇蝚輮韖騥鰇鶔
rou4	肉月宍
ru2	如儒茹嚅濡孺蠕薷铷襦颥乳帤挐曘桇渪燸筎臑蕠袽邚醹銣顬鱬鴽
ru3	辱乳汝侞女擩肗
ru4	入褥缛洳溽蓐傉嗕媷孺縟茹辱鄏
ruan3	软阮朊媆瑌瓀碝礝緛耎腝蝡蠕軟輭
rui2	蕤婑甤緌
rui3	蕊惢桵橤繠蕋蘂蘃
rui4	瑞锐芮睿枘蚋叡壡汭蜹銳鋭
run4	润闰橍潤膶閏閠
ruo4	若弱偌箬叒楉爇篛蒻鄀鰙鰯鶸
sa1	撒仨挲
sa3	洒撒潵灑訯靸
sa4	萨卅飒脎撒攃櫒薩钑隡颯馺
sai1	思塞腮鳃噻恖愢揌毢顋鰓
sai4	赛塞僿嗮簺賽
san1	三叁毵參叄嘇弎攕毿犙鬖
san3	散伞馓糁霰仐佡傘糂糝糣糤繖鏾鐁饊
san4	散俕閐
sang1	丧桑喪枽桒
sang3	嗓搡磉颡褬鎟顙
sang4	丧喪
sao1	骚搔臊缲缫鳋艘慅掻溞繅颾騒騷鯵鰠鰺鱢
sao3	扫嫂掃
sao4	扫梢臊埽瘙掃氉
se4	色塞涩瑟啬铯穑嗇懎擌歮歰渋澀澁濇濏瀒犞璱穡繬翜譅趇轖銫雭飋
sen1	森幓曑椮槮穼篸罧蔘襂
seng1	僧鬙
sha1	杀沙刹纱杉莎煞砂挲鲨痧裟铩乷帴摋榝樧殺猀粆紗蔱鎩髿魦鯊鯋
sha3	傻儍
sha4	沙啥厦煞霎嗄歃唼倽喢帹廈箑翣萐閯
shai1	筛酾篩簛籭
shai3	色繺骰
shai4	晒曬殺閷
shan1	山衫删煽扇珊杉栅跚姗潸膻芟埏钐舢苫髟搧傓刪剼姍彡挻杦椙檆澘烻狦穇笘縿羴羶脠軕邖釤
shan3	闪陕掺掸僐摻撣晱睒覢閃陜陝陿
shan4	单善扇禅擅膳讪汕赡缮嬗掸骟剡苫鄯钐疝蟮鳝掞墡儃單墠摲撣椫煽磰禪繕蟺訕謆譱贍赸釤銏鐥饍騸鱓鱔鳣
shang1	商伤汤殇觞熵墒裳傷慯殤湯滳漡蔏螪觴謪鬺
shang3	上赏晌垧丄扄賞鑜
shang4	上尚绱丄仩凃姠尙爙緔銄
shang5	裳上
shao1	烧稍梢捎鞘蛸筲艄弰旓焼燒莦蕱輎髾鮹
shao2	勺韶苕杓芍圴牊玿竰
shao3	少
shao4	少绍召稍哨邵捎潲劭卲佋娋睄紹綤袑颵
she1	奢赊猞畲奓檨譇賒賖
she2	折舌蛇佘什揲甚虵蛥鉈鍦铊闍阇
she3	舍捨舎
she4	社设舍涉射摄赦慑麝滠歙厍拾厙弽懾捑捨摂攝欇渉灄舎葉蔎蠂設韘騇
shei2	谁誰
shen1	身深参申伸绅呻莘娠诜砷糁珅燊侁信參叅妽屾峷扟敒柛氠甡甧眒籶籸糂糝紳葠薓裑訷詵鉮阠駪鲹鵢
shen2	什神甚希
shen3	审沈婶谂哂渖矧瞫嬸宷寀審弞瀋矤覾訠諗讅谉邥頣魫
shen4	甚慎渗肾蜃葚胂椹侺愼抻昚沁涁滲瘆瘎瘮眘脤腎鋠
sheng1	生声胜升牲甥笙昇勝呏斘曻殅泩湦焺狌狕珄竍竏竓竔竕竡聲苼鉎阩陞鵿鼪
sheng2	绳渑憴溗澠縄繩譝鱦
sheng3	省眚偗箵
sheng4	胜圣盛乘剩嵊晟乗剰勝墭晠椉榺琞聖蕂貹賸
shi1	师诗失施尸湿狮嘘虱蓍酾鲺呞噓屍師浉湤溮溼濕獅箷絁葹蒒蝨螄褷襹詩识邿釃鈟鯴鰤鳲鳾鶳鸤
shi2	时十实什识食石拾蚀埘莳炻鲥寔祏実湜時實乭兙喰塒射峕提旹榯湁溡碩竍竕蒔蝕遈鉐飠饣鰣鼫鼭
shi3	使始史驶屎矢豕乨兘宩笶鉂駛
shi4	是事世市士式视似示室势试释适氏饰逝誓嗜侍峙仕恃柿轼拭噬弑谥莳贳铈螫舐筮识媞適奭礻栻知視丗亊佀使冟勢卋卶叓呩嬕崼弒徥戠戺揓昰枾柹澨烒眂眎睗簭翨舓蒔衋褆襫詍試諟諡謚識貰跩軾遾釈釋鈰鉃鉽銴鋬飾餙餝齛
shi5	殖匙十识是食释实势
shou1	收収荍
shou2	熟手首
shou3	手首守艏垨扌掱
shou4	受授售瘦寿兽狩绶獣壽夀涭獸痩綬膄鏉
shu1	书输殊舒叔疏抒淑梳枢蔬倏菽摅姝纾毹殳疋疎倐圕尗摴攄書杸樗樞橾祋紓綀藲踈軗輸陎鵨
shu2	熟孰赎塾秫淑叔埱掓焂璹菽虪襡贖跾鸀
shu3	数属署鼠薯暑蜀黍曙糬婌屬數潻癙薥藷襩钃韣鼡
shu4	数术树述束竖恕墅漱俞戍庶澍沭腧曙丨侸倏儵兪凁尌庻捒數樜樹潄濖疏竪絉署翛蒁術裋豎鉥錰鏣鶐
shua1	刷唰鮛
shua3	耍
shua4	刷誜
shuai1	衰摔孈縗
shuai3	甩
shuai4	率帅蟀卛咰帥繂
shuan1	栓拴闩閂
shuan4	涮腨
shuang1	双霜孀泷孇欆滝瀧礵艭雙驦骦鷞鸘鹴
shuang3	爽塽樉慡漺縔騻
shui2	谁水脽誰
shui3	水氵氺
shui4	说税睡蜕帨涗涚瞓祱稅蛻裞說説
shun3	吮揗楯盾賰
shun4	顺舜瞬橓瞚蕣順鬊
shuo1	说說哾説
shuo4	数朔硕烁铄妁蒴槊搠箾勺帥揱數欶爍獡率矟碩蟀鎙鑠
si1	思斯司私丝撕厮嘶鸶咝澌缌锶蛳俬偲凘厶厷噝媤廝恖楒榹泀燍磃禗絲緦罳蕬蜤螄蟖蟴覗謕鉰鋖鍶颸飔騦鷥鼶
si3	死
si4	四似食寺肆伺饲嗣巳祀驷泗俟汜兕姒耜笥赐涘禩亖佀儩喰娰孠杫柶泤洍瀃牭竡竢肂蕼貄賜釲鈻飠飤飼饣駟
si5	司思厕厠
song1	松忪淞崧嵩凇菘倯娀庺憽枀枩柗梥檧濍硹蜙鬆
song3	耸悚怂竦傱嵷愯慫楤聳駷
song4	送宋诵颂讼訟誦頌餸
sou1	搜艘馊嗖溲飕锼螋捜鄋騪廀廋摉獀蒐醙鎪颼餿
sou3	擞叟薮嗾瞍傁叜擻櫢籔藪謏
sou4	嗽擞擻瘶
su1	苏稣酥窣蘇囌櫯甦穌蘓
su2	俗
su4	诉速素肃宿缩塑溯粟簌夙嗉谡僳愫涑蔌觫骕鹔告傃塐嫊愬憟栜榡樕橚殐泝洬溸溹潚潥玊珟璛碿粛縤縮肅膆蓿藗蜶訴誎謖趚蹜遡遫遬鋉餗驌鱐鷫
suan1	酸狻痠
suan4	算蒜筭祘笇
sui1	虽尿荽睢眭濉哸夊奞娞毸浽滖熣綏芕荾雖鞖
sui2	随遂隋绥綏遀隨雟
sui3	髓嶲巂瀡膸靃髄
sui4	岁碎遂祟隧邃穗燧谇穂睟歳亗埣嬘嵗旞檅檖歲澻煫璲瓍砕禭穟粋繀繸襚誶譢賥鐆鐩
sun1	孙荪狲飧孫搎槂猻蓀蕵薞飱
sun3	损笋榫隼損筍箰簨鎨
suo1	缩莎梭嗦唆挲娑睃桫嗍蓑羧傞挱摍桬樎簑簔縮莏趖鮻
suo2	所索
suo3	所索锁琐唢嗩摵暛溑琑瑣璅瘷褨鎍鎖鎻鏁鏼
ta1	他她它踏塌遢溻铊趿愵牠祂禢褟釶鉇鉈
ta3	塔鳎獭墖榙溚獺鎝鰨
ta4	踏拓榻嗒蹋沓挞闼漯遢亣傝嚃嚺崉搨撻橽毾涾溻澾濌狧獺羍誻譶蹹躂躢迖遝錔鎉鑉闒闥阘鞜鞳鮙鰨龖龘
tai1	台胎苔囼坮孡臺
tai2	台抬苔邰薹骀炱跆鲐枱臺儓坮嬯擡旲檯炲秮籉菭颱駘鮐
tai3	呔
tai4	太态泰汰酞肽钛冭夳忲態溙燤粏舦鈦
tan1	摊贪滩瘫坍啴怹抩探擹攤灘癱緂舑貪
tan2	谈弹坛谭潭覃痰澹檀昙锬镡郯倓墰墵壇壜婒弾彈憛曇榃橝罈罎藫談譚貚醈醰錟鐔餤騨驔鷤黮
tan3	坦毯忐袒钽嗿憳憻璮菼裧襢贉醓鉭
tan4	探叹炭碳嘆埮歎湠
tang1	汤趟铴镗耥羰蹚劏嘡坣湯蝪鏜鐋鞺鼞
tang2	堂唐糖膛塘棠搪溏螳瑭樘镗螗饧醣傏啺榶橖漟煻磄禟篖糃糛膅蓎薚赯踼鄌鎕鏜闛隚餳餹饄鶶
tang3	躺倘淌傥帑镋伖伥偒儻戃敞曭爣矘耥鎲钂
tang4	趟烫摥燙鐋
tao1	涛掏滔叨焘韬饕绦夲嫍幍弢慆搯槄濤燾瑫絛縚縧翢蜪詜謟轁鞱韜飸
tao2	逃陶桃淘萄啕洮鼗匋咷梼檮濤燾祹綯绹裪迯醄鋾錭鞀鞉饀駣騊
tao3	讨討
tao4	套
te4	特忑忒慝铽蚮螣蟘貣鋱鴏
tei1	忒
teng2	腾疼藤誊滕儯幐漛籐籘縢螣謄駦騰驣鰧
ti1	体踢梯剔锑涕掦焍銻鷈鷉
ti2	提题啼蹄醍绨缇鹈荑騠偍厗嗁堤媂媞崹惿漽珶瑅睼碮禔禵稊綈緹罤苐蕛蝭趧蹏遆鍗隄題鮷鯷鳀鴺鵜鶗鶙
ti3	体挮躰軆骵體
ti4	替涕剃惕屉嚏悌倜逖绨裼薙俤俶嚔屜悐惖揥歒殢籊綈褅迏逷銻鐟髢髰鬀鬄鵜
tian1	天添婖倎兲屇沗酟靝黇
tian2	田填甜恬佃阗畋钿嗔湉塡畑鷏沺璳甛盷磌窴胋菾鈿闐鷆
tian3	腆舔忝殄琠唺悿晪淟痶睓蚕覥觍賟靦餂
tian4	掭煔瑱舚
tiao1	挑佻祧庣恌旫聎鮡
tiao2	条调迢鲦苕髫龆蜩笤佻岧岹條樤祒芀萔調趒銚鋚鎥铫鞗鰷齠
tiao3	挑窕脁嬥宨斢晀朓誂
tiao4	跳眺粜朓窱糶絩脁覜
tie1	贴帖萜怗貼
tie3	铁帖僣鉄鐡鐵驖
tie4	帖餮蛈飻
ting1	听厅汀烃町桯聴厛庁廰廳烴耓聼聽艼鞓
ting2	停庭亭婷廷霆蜓葶莛嵉朾楟榳渟筳綎聤蝏諪邒閮鯅鼮
ting3	挺艇町铤梃珽侹圢涏烶甼脡誔鋌頲颋
ting4	梃聽
tong1	通恫嗵樋彤炵狪痌蓪
tong2	同童彤铜桐瞳佟酮侗仝垌茼峒潼砼硐僮鲖烔筒勭哃峂峝庝晍曈朣橦氃浵烕燑爞犝獞眮秱穜粡絧罿膧艟蕫詷迵鉖鉵銅餇鮦鼨
tong3	统筒桶捅侗姛筩統綂
tong4	同通痛恸慟憅蘳衕
tou1	偷偸婾媮
tou2	头投骰亠坄牏牐酘頭
tou3	钭妵媮紏蘣鈄黈
tou4	透斢
tu1	突秃凸堗宊嶀捸涋痜禿葖鋵鵚
tu2	图途徒屠涂荼菟酴凃土図余凸圕圖圗塗峹嵞庩廜怢捈揬梌湥潳瑹瘏稌突筡腯莵蒤跿鈯鍎馟駼鵚鶟鷋鷵鼵
tu3	土吐钍唋圡釷
tu4	吐兔堍菟兎莵鵵
tuan1	湍煓猯貒
tuan2	团抟剸団團慱摶槫漙糰鏄鷻
tuan3	疃黗
tuan4	彖褖
tui1	推忒蓷藬
tui2	颓魋僓弚橔穨蘈蹪隤頹頺頽
tui3	腿俀蹆骽
tui4	退褪蜕煺娧蛻駾
tun1	吞暾呑啍噋旽朜涒
tun2	屯饨臀囤豚炖鲀忳拵臋芚豘軘霕飩魨
tun3	氽畽
tun4	褪螁
tuo1	托脱拖乇扥侂侻咃堶拕挩捝汑沰涶矺脫託詑讬饦馲魠
tuo2	陀舵驼砣驮沱跎坨鸵橐佗铊酡柁鼍托岮槖狏砤碢紽袉迱釶鉇鉈阤陁鞁飥馱駄駝駞騨驒鮀鴕鼉鼧
tuo3	妥椭庹媠嫷彵撱楕橢鰖鵎
tuo4	魄拓唾柝箨毤毻籜萚蘀跅驝
wa1	挖哇凹娲蛙洼劸呱坬媧屲搲攨溛漥畖穵窪聉鼃
wa2	娃瓦
wa3	瓦佤咓瓩邷
wa4	瓦袜腽嗢膃襪韈韤
wa5	哇娃
wai1	歪
wai3	崴
wai4	外
wan1	湾弯蜿剜豌灣塆帵彎潫莞
wan2	完玩顽丸纨芄烷碗婉刓婠岏抏汍琓紈頑
wan3	晚碗挽婉惋宛莞娩畹皖绾琬脘菀浣倇啘埦晩晼梚椀涴盌盶睌睕綩綰脕萖葂蜿輓鋄鋔錽鞔
wan4	万腕蔓妧萬仴卍卐忨捥玩綄翫蟃貦贎踠鎫
wang1	汪傟尢尣尩尪尫
wang2	王亡芒往网亾仼兦彺忘蚟
wang3	往网枉惘罔辋魍徃徍忹暀棢瀇網罓臦菵蛧蝄誷輞迬
wang4	望王往忘旺妄徃朢莣迋
wei1	威微危巍萎偎薇逶煨崴葳隈委喴媁媙愄揋椳楲渨溦溾烓煹燰碨葨蝛覣隇鰃鰄鳂
wei2	为维围唯违韦惟帷帏圩囗潍桅嵬闱沩涠位薇危囲圍巍幃微欈洈湋潙潿濰濻瀢為爲琟癓矀維覹違鄬醀鍏闈霺韋鮠
wei3	委伟唯尾玮伪炜纬萎娓苇猥痿韪洧隗诿艉鲔亹梶薳頠偉僞儰喡壝寪峗崣嵔徫愇斖暐椲浘煒瑋痏硊磈緯腲芛荱葦蒍蓶蔿蘤蜲諉踓鍡韑韙韡颹骩骪骫鮪
wei4	为位未味卫谓遗慰魏蔚畏胃喂尉渭猬軎亹偽媦嬒徻懀為熭爲犚犩璏硙磑穌緭罻苿菋薉藯蘶蜼蝟螱衛衞褽謂讆讏贀躗躛轊遺錗鏏霨餧餵鮇鳚
wen1	温瘟塭昷殟溫瑥瞃蕰豱輼轀辒馧鰛鰮鳁
wen2	文闻纹蚊雯璺阌稳炆玟珳琝瘒紋聞芠蚉螡蟁閺閿闅闦馼駇魰鳼鴍鴖鼤
wen3	稳吻紊刎呡桽穏穩肳脗
wen4	问纹汶璺紊搵伆免問妏抆揾文渂熓紋聞莬
weng1	翁嗡鶲奣嵡滃螉鎓霐鹟
weng3	蓊勜塕暡浻瞈聬
weng4	瓮蕹甕罋齆
wo1	窝涡蜗喔倭挝莴唩撾涹渦猧窩萵蝸踒
wo2	哦我
wo3	我诉给婐捰
wo4	握卧哦渥沃斡幄肟硪龌偓捾楃濣礒臥齷
wu1	於恶屋污乌巫呜诬兀钨邬圬剭嗚媉弙惡杇歍汙汚洿烏窏箼腛螐誣鄔鎢陓鰞鴮
wu2	无亡吴吾捂毋梧唔芜浯蜈鼯五舞诬無鹀俉兦吳呉娪峿巫洖牾珸璑瞴祦禑茣莁蕪蟱誈誣譕郚鋘鋙铻鯃鵐鷡麌
wu3	五武午舞伍侮捂妩忤鹉牾迕庑怃仵倵儛啎娬嫵嵨廡憮摀橆潕玝珷瑦甒碔躌鄥鵡
wu4	物务误恶悟乌雾勿坞戊兀晤鹜痦寤骛芴杌焐阢婺鋈钨嵨靰毋務卼噁埡堊塢奦屼岉嵍忢悞悪悮惡扤敄旿沕溩烏煟熃矹窹粅蓩蘁誤逜遻隖霚霧騖鰞鶩齀
xi1	西息希吸惜稀悉析夕牺腊昔熙兮溪嘻锡晰樨熄膝栖郗犀曦奚羲唏蹊淅皙汐嬉茜熹烯翕蟋歙浠僖穸蜥螅菥舾矽粞硒醯欷鼷豨貕晞憙悕肸鸂晳俙傒僁凞卥厀唽噏嚱娭媐嬆屖嵠巂巇徆徯忚怷怸恓惁扱扸捿攜桸棲榽橀歖氥渓漆潝焈煕熈熺熻燨爔犠犧琋瓗畦疧瘄盻睎瞦磎礂窸縘繥臈臘莃蒵螆螇螝蠵裼覀觹觽觿譆谿豀豯赥郋酅釐錫鏭闟隵饻騱驨鵗黊
xi2	席习袭媳檄隰觋锡熄嶍息惜昔棤椺槢欯漝焟焬獥瘜習蒠蓆薂蝷裼褶襲覡謵趘錫鎴霫飁騽鰼鳛
xi3	喜洗禧徙玺屣葸蓰铣枲囍乴匚憘憙敼暿漇狶璽矖簁縰纚葈蟢諰蹝躧鉩銑霼鰓鱚
xi4	系细戏隙饩阋禊舄汐潟矽郤係匸卌咥喺夕屃屓屭忥怬恄戯戱戲摡椞歙滊澙熂犔磶稧細綌繋繫绤翕翖肸肹舃蕮虩覤謑赩鄎醯釳釸鎎鑴隟餼鬩黖齂
xia1	瞎虾呷傄煵疨蝦鍜閕颬鰕
xia2	峡侠狭霞暇辖遐匣黠瑕狎硖瘕柙俠冾呷峽挾搳敮斜洽炠烚狹珨硤碬磍祫笚筪縖翈舝舺蕸赮轄鎋陝騢魻
xia4	下夏吓厦唬罅丅嚇夓廈懗暇欱疜睱芐鏬鶷
xian1	先鲜仙掀纤暹莶锨氙祆籼酰跹掺仚僊僲嘕奾嬐孅尠屳廯忺憸杴枮澖灦珗秈繊纎纖苮蓒薟褼襳訮蹮躚銛鍁铦韯韱馦鮮鱻
xian2	闲贤嫌咸弦娴衔涎舷鹇痫閑蚿唌啣娹婱嫺嫻憪挦撏燅甉痃癇癎瞯礥絃羬胘葴藖蛝衘諴賢贒輱醎銜閒鷳鷴鷼鹹
xian3	显险鲜洗跣猃藓铣燹蚬筅冼癣狝尟険姺崄嶮幰搟攇櫶毨烍獫獮玁癬禒箲蘚蜆赻銑鍌險韅顕顯鮮鼸齴
xian4	现见线限县献宪陷羡馅腺岘苋霰現蚬県伣俔僩僴咞哯垷姭娊娨峴憲撊晛橌涀瀗獻睍粯絤綫線縣缐羨臔臽莧蜆見誢豏轞鋧錎陥餡麲
xiang1	相香乡箱厢湘镶襄骧葙芗缃鄕啌廂忀欀瓖緗纕薌郷鄉鄊鑲驤鱜麘
xiang2	降详祥翔庠想佭夅栙珦絴詳跭
xiang3	想响享飨饷鲞嶑晑響餉饗饟鮝鯗鱶
xiang4	相向象像项巷橡蟓勨嚮恦曏潒萫蚃蠁襐鐌闀闂項鱌
xiao1	消销潇肖萧宵削嚣逍硝霄哮枭骁箫枵哓蛸绡魈銷蠨清鸮虓猇呺啋嘋嘐嘵嚻囂婋宯庨彇憢撨梟櫹歊毊涍潚瀟灱灲烋焇獢痚痟硣穘窙簘簫綃膮萷蕭藃虈蟏蟰踃驍髇鴞
xiao2	淆崤小學洨笅訤誵郩
xiao3	小晓筱暁曉皢筿篠謏
xiao4	笑校效肖孝啸哮効咲俲傚嘨嘯恔敩斆歗滧熽薢誟踍酵鞩
xie1	些歇楔蝎猲嗋揳蠍褉
xie2	叶协鞋携斜胁谐邪挟偕撷勰颉缬写劦協垥奊恊愶慀拹挾搚擕擷攜旪熁燲瑎籺絜綊纈翓脅脇脋脥膎葉蝢衺襭諧鞵頡鮭鲑龤
xie3	写血冩寫藛蠏
xie4	写解谢泄契械屑卸懈泻亵蟹邂榭瀣薤燮躞廨绁渫榍獬伳偰卨塮妎娎媟屟屧嶰徢斺暬楔泣洩澥瀉灺焎爕疶祄禼糏紲絏絬緤缷蠏衸褻觧謝躠鞢韰駭駴骱齘齥
xin1	心新欣辛薪馨鑫芯昕忻歆锌莘炘嬜俽兟噷妡廞忄惞炛盺訢鈊鋅
xin2	寻镡尋攳杺樳襑鄩鐔
xin4	信芯衅囟伩卂妡孞焮煡脪膷舋訫軐釁阠顖馸
xing1	兴星腥惺猩垶曐煋瑆皨篂興蛵觪觲鍟馨馫騂骍鮏鯹
xing2	行形型刑邢陉荥饧硎侀坓洐滎濚濴烆胻郉鉶銒鋞钘铏陘餳餹
xing3	省醒擤渻睲
xing4	性兴姓幸杏悻荇涬倖婞嬹懬緈臖興莕行踁
xiong1	兄胸凶匈汹芎兇哅忷恟洶胷訩詾讻賯
xiong2	雄熊赨
xiu1	修休羞咻馐庥鸺貅髹脩俢樇潃烌臹茠蓚蓨銝鎀鏅饈髤鵂
xiu3	宿朽滫糔綇
xiu4	秀袖宿臭绣锈嗅岫溴琇峀殠珛綉繍繡臰螑褎褏銹鏥鏽齅
xu1	需须虚吁嘘墟戌胥砉圩盱顼虛訏歔旴倠呴噓媭嬃嬬幁揟晇楈欨欰殈湏疞稰籲縃繻蕦虗蝑譃鑐須頊驉鬚魆魖
xu2	徐俆蒣
xu3	许浒栩诩糈醑冔許偦喣姁湑滸煦珝盨詡諝谞鄦
xu4	续序绪蓄叙畜恤絮旭婿酗煦洫溆勖垿壻慉伵侐勗卹嘼怴敍敘昫朂槒汿沀漵潊烅珬盢瞁瞲稸窢続緒緖續聟藇藚訹賉銊鱮
xu5	蓿
xuan1	宣喧轩萱暄谖揎儇煊瑄佡吅塇塤壎媗嬛弲愃愋昍晅梋煖睻矎禤禫翧翾萲蕿藼蘐蝖蠉諠諼譞軒鋗鍹鶱
xuan2	旋悬玄漩璇痃选玹伭妶嫙懸暶檈琁璿縣蜁誸還
xuan3	选癣烜咺癬選
xuan4	旋券炫渲绚眩铉泫碹楦镟埍怰昡楥眴絢縼繏蔙衒袨讂贙鉉鏇鞙颴駽
xue1	削靴薛吙嶨辥鞾
xue2	学穴噱踅泶學壆峃斅斈澩燢茓觷雤鷽鸴
xue3	雪鳕膤鱈
xue4	血谑削坹岤桖泬穴袕謔謞趐雪
xun1	熏勋荤醺薰埙曛窨獯纁勛勲勳坃塤壦焄焅燻矄臐葷蔒薫蘍
xun2	寻询巡循旬驯荀峋洵恂郇浔鲟荨珣鄩偱噚尋廵徇杊枔栒桪槆橁毥潯燖璕畃紃蕁蟳詢馴駨鱏鱘
xun4	训迅讯逊熏殉巽徇汛蕈浚驯伨侚噀巺殾爋訊訓訙賐迿遜鑂韗顨馴鵔鵕
ya1	压雅呀押鸦哑鸭丫垭桠圧吖唖啞埡壓孲庘椏煆鴉鴨鵶
ya2	牙涯崖芽衙睚伢岈琊蚜雅厓堐崕押枒漄犽猚玡笌谺齖
ya3	雅瞧匹痖疋哑亞厊啞庌掗瘂蕥雃
ya4	亚压讶轧娅迓揠氩砑亜亞俹劜圠圧垭壓婭挜氬猰稏窫聐襾訝軋錏铔齾
ya5	呀
yan1	烟燕咽殷焉淹阉腌嫣胭湮阏鄢菸崦恹偣剦厭啱奄嬮懕懨漹煙猒珚篶臙酀醃閹閼
yan2	言严研延沿颜炎阎盐岩铅蜒檐妍筵芫闫阽眼嵒讠塩厳嚴圤壛壧姸娫娮孍嵓巌巖巗揅昖楌櫩湺狿琂癌硏碞礹簷綖莚葕蔅虤訁詽郔鈆鉛閆閰閻顃顏顔鹽麙麣
yan3	眼演掩衍奄俨偃魇鼹兖郾琰罨厣剡鼽弇沇黡縯乵儼兗匽厴夵姶嵃嶖巘巚惔愝戭扊抁揜曮棪椼檿渰渷甗硽萒蝘裺褗躽遃酓隒馣魘鰋鶠黤黭黶鼴龑
yan4	研验沿厌燕宴咽雁焰艳谚彦焱晏唁砚堰赝餍滟酽谳闫験喭騴偐傿厭噞嚈嚥墕墱妟姲婩嬊嬿彥懨敥暥曣椻淹灎灔灧灩焔焸燄爓爗牪硯艶艷莚覎觃觾諺讌讞豓豔贋贗醶醼釅閆隁饜騐驗驠鳫鴈鴳鷃鷰
yang1	央泱秧鸯殃鞅佒坱姎柍眏紻胦鉠雵鴦
yang2	洋阳杨扬羊疡佯烊徉炀蛘养仰珜陽劷垟婸崵揚敭旸昜暘楊煬玚瑒瘍眻禓諹輰鍚鐊钖阦霷颺飏鰑鸉
yang3	养仰痒氧卬岟慃懩抰攁氱炴癢羏羪蝆鞅養餋駚
yang4	样漾恙烊怏鞅杨様樣瀁煬羕詇養
yao1	要约邀腰夭妖吆幺么喓楆祅約葽訞
yao2	摇遥姚陶尧谣瑶窑肴侥铫珧轺爻徭繇鳐垚揺倄傜僥嗂堯媱尭峣崤嶢嶤愮搖暚柼榣殽淆烑猇猺瑤窯窰蘨謠謡軺遙銚鑃顤颻飖餆餚鰩鼼
yao3	咬杳窈舀崾騕仸偠夭婹嫍宎岆抭枖榚殀溔眑窅窔苭蓔闄鷕
yao4	要药耀钥鹞曜疟矅拗熎燿獟瘧穾筄艞葯薬藥袎覞讑趭鑰靿鷂
ye1	耶噎椰掖晔倻蠮
ye2	爷耶邪揶铘也野琊椰峫捓擨爺瑘釾鋣鎁
ye3	也野冶埜嘢吔壄漜
ye4	业夜叶页液咽哗曳拽烨掖腋谒邺靥晔堨亱偞僷嘩墷射嶪嶫忦擛擪擫曄曅曗枼業殗殜澲煠燁皣瞱瞸葉謁鄴鍱鎑鐷靨頁餣饁馌驜鵺鸈
yi1	一医衣依椅伊漪咿揖噫猗壹铱欹黟祎吚壱夁嫛嶬弌檹殹毉洢溰燚瑿禕稦竓竕竡繄蛜衤譩郼醫銥陭餏鷖鹥黳
yi2	移疑遗宜仪蛇姨夷怡颐彝咦贻迤痍胰沂饴圯荑诒眙嶷一已以谊簃乁侇儀冝匜宐宧寲峓巸弬彛彜彞恞悘扅暆杝柂栘桋椸歋沶洟熪珆瓵眤眱箷羠苐萓虵蛦螔衪袘袲觺訑詒誼謻讉貤貽跠迆迻遺酏鈘鈶銕頉頤頥顊飴鮧鸃
yi3	以已衣尾椅矣乙蚁倚迤蛾旖苡钇舣酏欺顗齮偯崺庡扆掜旑晲檥礒笖肔胣艤苢螘蟻輢轙迆逘釔鉯陭鳦
yi4	意义议易衣艺译异益亦亿忆谊抑翼役艾溢毅裔逸轶弈翌疫绎佚奕熠诣弋驿懿呓屹薏噫镒缢邑臆刈羿仡峄怿悒肄佾殪挹埸劓镱瘗癔翊蜴嗌翳一腋鞥裛浥乂宜泆潩豷亄伇伿俋億兿劮勚勩呭呹唈囈圛垼埶墿嫕嬑嬟寱嶧帟帠幆廙怈悥憶懌抴捙掖撎敡斁晹曀曎曳杙枍枻栧棭榏槷槸檍欭歝殔洂浂浳液湙澺瀷炈焲熤熼燡燱獈玴異痬瘞瘱瞖秇穓竩緆縊繶繹羛義肊膉艗芅苅蓺藙藝蘙虉蛡螠袣褹襼訲訳詣誼謚譯議讛豙豛跇軼酏醳醷釴鈠鎰鐿阝阣隿霬靾顡食饐駅驛骮鯣鷁鷧鷾鹝鹢黓齸
yin1	因音烟阴姻殷茵荫喑湮氤堙洇铟愔蒑吟侌凐噾囙垔婣峾慇摿歅洕溵瘖禋秵筃絪緸绬蔭裀諲銦闉阥陰陻隂霠鞇韽韾駰骃黫
yin2	银吟寅淫垠鄞霪狺夤圻龈饮引隐訚銀冘凐唫噖嚚圁婬崟崯斦檐檭殥泿滛烎璌碒苂荶蔩蟫訔訡誾釿鈝鏔鷣齦龂
yin3	引隐饮瘾殷尹蚓吲飮淫乚听嶾廴檃櫽淾濦癮磤粌紖縯蘟螾讔趛鈏隠隱靷飲馻
yin4	印饮荫胤茚窨廕垽慭憖憗懚朄檼湚濥猌癊蔭酳隱飮飲鮣
ying1	应英鹰婴樱膺莺罂鹦缨瑛璎撄嘤媖锳罃蘡蠳偀嚶嫈嬰孆孾応應攖朠桜楧櫻渶煐珱瓔甇甖碤礯纓罌蝧褮譻鍈鑍霒霙韺鴬鶧鶯鷪鷹鸎鸚
ying2	营迎赢盈蝇莹荧萤萦瀛楹嬴茔滢潆荥蓥影盁営僌塋媖巆廮攍櫿溁滎濙濚瀅瀠瀯熒營瑩籝籯縈萾藀蛍蝿螢蠅謍贏鎣
ying3	影颖颍瘿郢巊景梬浧潁瀴璄癭矨穎頴颕
ying4	应硬映媵噟応應摬暎瀅膡譍賏鎣鐛鞕
yo1	育哟唷喲
yo5	哟喲
yong1	拥庸佣雍臃邕镛墉慵痈壅鳙饔傭嗈噰廱擁滽澭灉牎癕癰蕯郺鄘鏞雝鱅
yong2	喁勇永颙傛傭嫆嫞嵱槦顒
yong3	永勇涌踊泳咏俑恿甬蛹臃勈埇塎壅彮悀惥愑愹慂搈擁柡栐湧禜詠踴銢鯒鲬
yong4	用佣傭醟
you1	优幽忧悠攸呦優嚘怮憂懮櫌瀀纋耰鄾麀
you2	由游油邮尤犹柚鱿莸尢铀猷疣蚰蝣蝤繇莜有友櫾楢偤尣峳怣斿沋浟滺猶秞肬莤蕕訧輏輶逌逰遊邎郵鈾駀魷鮋鲉
you3	有友黝酉莠牖铕丣卣岰庮梄槱泑湵禉羐羑聈脜苃蜏銪
you4	有又右幼诱佑柚囿鼬宥侑蚴釉祐亴哊唀姷峟牰狖糿誘貁迶酭鴢
yu1	於吁迂淤纡瘀込峿扜毺盓穻箊籲紆虶迃
yu2	于与余予鱼愚舆娱愉馀逾渔渝俞萸瑜隅揄榆虞禺谀腴竽妤臾欤觎盂窬蝓嵛狳舁雩於雨嵎邘伃亐兪唹堣堬娛娯媀嬩崳扵旟杅桙楡楰歈歟歶湡漁澞玗玙璵畬畭睮硢籅緰羭艅茰蕍蘛螸衧褕覦諛謣踰輿轝鄃釪鍝隃雓雽餘骬髃魚魣鮽鰅鵌鷠鸆鸒齵
yu3	与语雨予宇羽禹圄屿龉伛圉庾瘐窳俣禺瑀楀鄅俁偊傴匬噳寙嶼懙敔斔斞祤窊篽聥與萭蘌螤語貐酑齬
yu4	与语育遇狱雨欲预玉愈谷域誉吁蔚寓豫粥郁喻裕浴御驭尉谕毓妪峪芋昱煜熨燠菀蓣饫阈鬻聿钰鹆鹬蜮彧萸淯薁悆俼叞喅喐喩噊圫堉嫗嶎庽忬悇惐慾戫栯棛棜棫櫲欎欝欥淢滪潏澦灪焴燏爩獄獝琙瘉癒矞砡硲礇礖礜禦禺秗稢稶穥籞籲糓緎繘罭肀與芌茟萮蒮蓹蕷蜟袬語諭譽軉輍逳遹醧鈺銉鋊錥鐭閾隩霱預飫饇馭騟驈鬰鬱魊鳿鴥鴪鵒鷸黦
yuan1	冤渊鸳眢鸢箢剈囦嬽宛寃惌棩淵渁渆渕灁肙葾蒬蜎蜵裫裷鋺駌鳶鴛鵷鹓鼘鼝
yuan2	员元原园源圆缘援袁猿垣辕沅媛芫橼圜塬爰螈鼋远杬円厡厵員圎園圓妧媴嫄尛榞榬櫞湲溒猨猭獂笎緣縁羱蒝薗蚖蝝蝯貟贠轅邍邧鎱騵魭鶢鶰黿
yuan3	远遠妴逺
yuan4	院愿怨苑媛掾垸瑗傆噮夗禐衏褑褤謜遠願
yue1	约曰矱人噦曱焥箹約
yue4	月越阅跃乐悦岳粤说钥刖瀹栎樾龠钺玥约妜岄嶽恱悅戉抈捳曜枂楽樂檪櫟泧爚狘礿禴篗籆籥籰粵耀藥蘥蚎蚏說説趯跀躍軏鈅鉞鑰閱閲鸑鸙龥
yun1	晕氲赟奫暈氳煴煾熉緼縕蒀蒕蝹贇
yun2	云匀筠芸耘纭昀郧允沄伝勻员員妘愪枃榅榲橒涢溳澐熅畇眃秐筼篔紜縜耺荺蒷蕓貟贠鄖鋆雲饂
yun3	允陨殒狁傊喗抎殞狇玧磒褞賱輑鈗阭隕霣
yun4	运均韵晕孕蕴酝愠熨郓韫恽惲员員囩夽慍暈枟緷缊腪薀藴蘊貟贠運鄆醖醞韞韻鶤
za1	扎咂匝拶帀抸沞紮臜臢迊鉔
za2	杂咱砸偺囐嶻磼襍雑雜雥韴魳
za3	咋鮺
zai1	灾哉栽甾渽災烖菑賳
zai3	载仔宰崽儎縡載
zai4	在再载縡侢傤儎扗載
zan1	簪糌傪兂簮鐕
zan2	咱倃偺
zan3	攒拶昝趱儧儹喒噇寁揝撍攅攢桚沯礸禶趲
zan4	赞暂瓒錾讃酇囋暫欑灒瓉瓚穳襸讚賛贊趲鄼鏨饡
zan5	咱
zang1	赃臧锗脏牂牃羘賍賘贓贜鍺髒
zang3	驵駔
zang4	藏脏葬奘匨塟弉臓臟蔵銺
zao1	遭糟傮蹧
zao2	凿早醩鑿
zao3	早澡枣蚤藻缲棗璪繰薻
zao4	造灶躁噪皂燥唣皁糟慥唕梍竃竈竉簉艁譟趮髞
ze2	则责泽择咋啧迮帻赜笮箦舴沢則嘖崱幘択擇澤皟瞔窄簀耫萴蔶蠈蠌諎謮責賊賾齚
ze4	侧仄昃側夨庂昗汄稄
zei2	贼賊鱡鲗
zen3	怎
zen4	谮譖譛
zeng1	曾增憎缯罾鄫増曽橧熷璔矰磳繒譄驓
zeng4	赠缯甑锃綜繒综贈鋥
zha1	查扎咋渣喳揸楂哳吒齄咤柤偧宱抯挓摣査樝皶皻茬謯齇
zha2	炸扎札喋轧闸铡油咋剳劄甴箚紥紮蚻蠿譗軋鍘閘霅
zha3	眨砟厏拃渣苲踷鮓鲊鲝
zha4	炸咋诈乍蜡栅榨柞吒咤痄蚱咜搾柵溠灹簎蝋蠟詐醡鮓
zhai1	摘侧斋捚斎榸齊齋
zhai2	择宅翟窄択擇礋
zhai3	窄岝鉙飵
zhai4	债祭寨砦瘵債責
zhan1	占沾粘瞻詹毡谵旃展鳣鹯邅呫噡嶦旜栴氈氊薝覘詀譠譫讝趈鉆霑饘驙鱣鸇
zhan3	展斩辗盏崭搌嶃嫸嶄斬榐樿橏琖皽盞蹍輾醆颭飐魙
zhan4	战站占颤绽湛蘸栈戦佔偡嶘戰暫桟棧椾綻菚虥虦覱蹔輚轏顫驏骣
zhang1	张章彰璋蟑樟漳嫜鄣獐傽張彣慞暲蔁遧餦騿鱆麞
zhang3	长掌涨仉長僟兏漲礃镸鞝
zhang4	丈涨帐障账胀仗杖瘴嶂幛墇帳扙涱漲痮瘬瞕粀脹賬
zhao1	着招朝嘲昭钊啁妱召巶摷晁柖盄著釗鉊鍣駋
zhao2	着著
zhao3	找爪沼爯瑵菬
zhao4	照赵召罩兆肇诏棹笊垗旐晁曌枛櫂炤燳狣瞾箌羄肁肈詔趙雿鵫
zhe1	折遮蜇嗻嫬晢晣螫
zhe2	折哲辙辄谪蛰摺磔蜇褶喆馲厇啠嚞埑悊慴懾摘晢杔歽瓋砓籷耴虴蟄襵詟謫謺讁讋讘輒輙轍銸鮿鸅
zhe3	者褶锗赭啫禇鍺
zhe4	这浙蔗鹧柘淛這宅檡烢蟅鷓
zhe5	着晢著遮
zhei4	这這
zhen1	真针珍斟贞侦甄臻箴砧桢溱蓁椹榛胗祯浈禛偵堻媜嫃寊帧帪幀搸栕楨樼湞潧獉珎瑊眞碪禎籈蒖蒧薽診貞轃遉酙針鉁錱鍮鍼靕駗鱵鷏
zhen3	诊枕疹缜畛轸稹弫抌抮昣晸槇眕祳笉紾絼縝縥聄袗診軫辴鬒黕黰
zhen4	阵镇震圳振赈朕鸩瑱侲塦娠挋揕敶枕栚桭椹眹纼蜄誫賑酖鎭鎮陣鴆
zheng1	正争征丁挣症睁徵蒸怔筝铮峥狰钲鲭诤佂埩姃崢徰徴掙揁炡烝爭猙癥眐睜箏篜聇諍踭鉦錚鏳鑁鬇鯖
zheng3	整拯愸抍撜氶糽
zheng4	政正证挣郑症怔铮诤帧佂幀掙癥証諍證鄭錚钲鴊
zhi1	之只知指支织氏枝汁掷芝吱肢脂蜘栀卮胝祗稙倁巵搘枳梔椥榰汥泜祇祬秓秖秪竓竕綕織胑衹衼跖隻馶鳷鴟鴲鼅
zhi2	直指职值执植殖侄踯摭絷跖埴只纸质鉄値儨坧執墌妷姪嬂慹懫擲擿柣桎樴漐犆瓆瓡禃秷稙縶聀職膱蘵蟄蟙褁質蹠蹢躑軄釞馽鯯
zhi3	只指纸止址旨徵趾咫芷枳祉轵黹酯至凪紙劧厎坁夂帋恉扺抧晊栺沚洔淽疻砋祇藢襧訨軹阯
zhi4	知至制识治志致质智置秩滞帜稚挚掷峙窒炙痔栉桎帙轾贽痣豸陟忮彘膣雉鸷骘蛭踬郅觯寘跱铚厔晊乿偫劕垁娡崻幟庢庤徏徝憄懥挃搱摯擲旘梽櫍櫛洷淛滍滯潌熫狾猂猘畤疐瘈礩祑秲稺穉筫紩緻翐胵腟臸芖虒螲袟袠製覟觗觢觶誌識豑豒貭質贄躓輊迣遰銍鋕鑕锧陦隲駤騭騺驇鴙鴩鷙
zhong1	中终钟忠衷锺盅忪螽舯柊伀刣妐幒彸汷泈潨炂煄籦終蔠衳蹱鈡銿鍾鐘鴤
zhong2	种
zhong3	种肿踵冢喠埫塚尰歱瘇種腫
zhong4	中种重众仲乑偅堹妕媑尰湩狆眾種筗緟茽蚛衆衶諥
zhou1	周州洲粥舟诌啁盩侜俼喌婤徟洀淍烐珘矪謅譸诪賙赒輈輖辀週銂騆鵃鸼
zhou2	轴妯碡妰軸
zhou3	肘帚晭疛睭箒菷鯞
zhou4	皱骤轴宙咒昼胄纣绉荮籀繇酎伷僽冑呪咮噣怞晝甃皺籒籕粙紂縐葤詋軸駎驟
zhu1	诸朱珠猪株蛛洙诛铢茱邾潴槠橥侏劯櫧櫫瀦硃祩絑藷藸蝫蠩袾觰誅諸豬銖鮢鴸鼄
zhu2	术逐筑竹烛躅竺舳瘃主劚朮灟炢燭爥窋笁笜築篫茿蓫蠋蠾術趉軸鱁
zhu3	主属煮嘱瞩拄褚渚麈丶囑壴孎屬斸欘濐煑眝矚砫罜著詝貯陼
zhu4	住注助著驻祝筑柱铸伫贮箸炷蛀杼翥苎疰鋳壴砫纻竚佇坾嵀柷樦櫡殶秼筯築紵紸羜芧苧莇註諔貯跓軴鉒鑄飳馵駐麆
zhua1	抓挝髽撾檛莴
zhua3	爪
zhuai1	拽
zhuai3	拽跩転轉转
zhuai4	曳拽嘬曵
zhuan1	专砖颛剸叀塼嫥専專瑼甎磚篿耑膞蟤鄟顓鱄鷒
zhuan3	转転囀竱轉
zhuan4	传转赚撰沌篆啭馔傳僎囀堟灷瑑籑縳腞蒃襈譔賺贃転轉饌
zhuang1	装庄妆桩妝娤梉樁粧糚荘莊裝
zhuang3	奘弉
zhuang4	状壮撞幢僮戆壵壯戇焋狀
zhui1	追锥隹椎骓娺桘腄錐騅鴭鵻
zhui4	坠缀赘惴缒叕墜硾礈窡笍綴縋膇譵贅錺鑆餟
zhun1	屯谆肫窀宒衠訰諄迍
zhun3	准凖埻準綧隼鶽
zhuo1	桌捉卓拙涿焯倬丵晫棁棹穛
zhuo2	着著琢缴灼酌浊濯茁啄斫镯诼禚擢浞卓斱倬剢劅啅圴彴拙撯擆斀斮斲斵梲棳椓槕汋泎濁灂炪烵焯琸硺篧籱繳罬蝃蠗諑謶鋜錣鐯鐲鷟
zi1	资咨滋仔姿吱兹孜谘呲龇锱辎淄髭赀孳粢趑觜訾缁鲻嵫鹚子嗞姕孖孶崰栥椔湽澬玆礠禌秶稵紎緇茊茲著葘蟕蠀諮貲資趦輜輺鄑鈭錙鍿鎡镃頾頿鯔鰦鴜鶅鶿鼒齍齜
zi3	子紫仔梓姊籽滓秭笫耔茈訾吇呰啙姉杍榟矷秄胏芓虸訿釨
zi4	自字渍恣眦倳剚孳扻洓漬牸眥胔胾茡
zong1	宗踪综棕鬃枞腙倧堫嵏嵕嵸怱惾椶樅熧猣磫稯綜緃緵縱翪艐葼蝬豵踨蹤騌騣骔鬉鬷鯮鯼
zong3	总偬総捴倊傯忩惣愡憁揔搃摠朡緫縂總蓗
zong4	纵粽综從昮猔疭瘲碂糉糭綜縦縱
zou1	邹诹陬鄹驺鲰媰掫棷棸箃緅菆諏謅郰鄒騶鯫黀齺
zou3	走赱
zou4	奏揍骤驟
zu1	租菹蒩
zu2	足族卒镞祖组崒伜傶卆哫嗾崪捽踤踿蹵鎐鏃
zu3	组祖阻诅俎爼珇組詛靻
zuan1	钻躜躦鑚鑽
zuan3	纂缵儹籫繤纉纘鑽
zuan4	赚钻攥賺鑚鑽饡
zui1	堆厜嶉朘樶纗
zui3	嘴咀觜噿嶊洅濢璻
zui4	最罪醉蕞冣墬嶵晬栬槜檇檌祽稡絊襊辠逨酔酻鋷錊
zun1	尊遵樽鳟墫壿嶟燇繜罇鐏鱒鷷
zun3	撙僔噂墫譐
zuo1	作嘬
zuo2	作昨琢笮左椊秨稓筰葃鈼
zuo3	左佐撮咗唨毑繓
zuo4	作做坐座怍胙阼唑祚凿夎岞柞砟糳葄袏酢鑿
zi5	子
ge5	个歌個
gu5	顾咕
biao2	表
sha2	啥
er5	儿
fan5	烦
tou5	头頭
jing2	井
ji5	记计疾积箕辑
guo5	过
zhi5	置质制指脂
niao2	袅
xi5	息系
ying5	蝇盈
jing5	睛
liang5	量亮粮粱
mou3	某冇踇
shan2	闪
lang5	朗
fen5	分
xiong5	兄
bu5	不部
hou5	候侯
ben2	本
zong2	总
tai5	太
mou2	谋某牟眸缪侔劺呣恈洠繆蛑謀鉾鍪鴾麰
lai5	来
niang5	娘
jian2	减柬
you5	友
guan2	管馆
yue5	月
diao5	掉
wu5	物务
xing5	猩
bing5	病饼
ruo5	弱
mu2	亩母模墲橅毪氁
zuo5	坐做
chui5	吹
yun5	晕
nve4	疟虐瘧謔
qie2	茄伽癿
zui2	嘴
rong5	溶
mei5	妹
kan5	看
kao2	考
he5	合和
sheng5	生
yang5	鸯扬阳
cheng5	诚
lv2	缕旅侣驴榈闾慺櫖櫚氀膢藘閭馿驢
dai5	袋待
jin2	紧
yao5	药
wang5	望枉王
jiu2	九
jun3	菌窘蜠
gei2	给
zheng2	整
nao5	闹
gun2	滚
tong5	同筒
dian2	点典
gui2	鬼
bei2	北
tao5	桃
lia2	俩
yi5	易议一意义
shen5	神
ling5	龄
weng5	嗡
qi5	气
qin5	亲
nai2	奶孻摨熋
lve4	略掠圙擽攊畧鋝锊
heng5	哼
nv2	女
ju5	矩
ye5	爷
mian5	面
rou5	柔
qia5	恰
pie2	撇
guang2	广
ka2	卡
ken2	恳
si2	死
dang2	党
yu5	育裕
wo5	窝
deng2	等
fa5	发
po5	婆
kong2	孔
zhen2	诊
gai2	改
pin5	频
wan5	玩
jiang2	讲奖
nai5	奶耐
mu5	目
shun5	顺
ne4	讷呐呢訥
dao5	到
nuan2	暖
piao5	飘
su5	诉
nang5	囊
long5	咙
zhu5	住
pian5	片
yong5	用
ou2	偶吽
hu5	乎
zou2	走
bai5	白
zhang2	长
bang2	榜
zhan2	展
huo5	活火咊和
tie2	铁
du5	度
zhuan2	转
chou5	酬
gan5	杆
sou5	嗽
hai5	害
jiong2	炯
jiu5	舅
duo5	朵掇
o1	噢喔
niu1	妞
sai5	噻
pou2	锫抔抙捊掊裒
fang5	坊
nan3	腩蝻赧戁揇湳
de	的地得
le	了饹
ma	吗嘛嗎
men	们們
zi	子
me	么麼
zhe	着著
tou	头
he	喝荷
shi	实识匙
ba	吧粑
o2	哦
fu	父服腐妇
fang	坊
ne	呢
a	啊
ｔ	ｔ
ya	呀
hu	乎糊唬
li	璃娌里
ａ	ａ
lu	芦
liang	量
qi	起
ｋ	ｋ
huo	伙和
di	弟
er	儿
jie	结
mo	磨麿
bo	膊卜伯
ｃ	ｃ
lao	姥
la	啦拉
ｂ	ｂ
wa	哇娃
lve3	掠
tan	弹
suo	嗦
jia	家
ji	家箕辑
po	婆
ju	矩
rang	嚷
bei	呗臂
yue2	跃
rong1	茸
n2	嗯我唔
da	瘩跶
shang	上裳
hou	候
sheng	声生
dao	叨
du	督
yu	澚
nan	难
jin	进
yi	易
tui	退
xin	忄
nang1	囔囊乪嚢
sang	丧
xu	蓿
na1	南那
chao	吵
pai3	迫俖排矲
ti	笹
nou4	耨啂嗕槈譨譳鎒鐞
nang3	曩攮灢饢馕
luo	罗
chang	场
chai3	茝
nv4	衄忸恧朒衂
chen	伧
lei	嘞
ke	壳
pou3	婄剖咅哣廍掊棓犃
bia3	柏
de1	嘚
pen4	喷噴
duo	掇
，	，
tun	饨
eng1	鞥
mi	迷
qq	q
den4	扥
nai	奶
qie	趄
none0	丆丷乄乊乛乤乥乧乬乮乯乲乺乻乼乽亇亪亽仒佦佨侤俧倿傦儏兯兺冧凧凩凪匁匂匇厁厑厼叾呚哖哘哛唜唟唥啹喸嗭嗴嘊嘥噺嚑嚒嚡囎囕囖圦圷圸垈垊垪垰垳埖堏堒塀塰墛墹壗壪壭夈夑夞夻奍娐婔婮婲媈媘媫嫲嬄嬜嬫嬳嬶孧尡屗屶屷岃岼岾峅峠崊嵵嵶嵻嶶嶿巪巬巭巼幉幥庒廤廭彁彅徔徚怺怽怾恷愥愱慐懳扖抣挘挧捤掵掶掹揻揼摗撶擜擝攚敾旀旕暃曕曢朑朥朰杁杢杣杤枠枤柨栃栆栍栶桛桝桞梺梻椚椛椡椣椦椧椨椩椬楾榁榊榋榌槝槡樭樮樰橲橳橴橵橸橺橻檲櫊櫔櫤櫦櫵櫷欌欍欕欟歄歚殝毜毝毟毮毶氞汢汣汼洜浌涥渏湪湭溄溊溋潈潉潱澝濸瀭瀮灐灜灳炿烥烪烮焁焑焒焹焽焾焿煀煯煶煷熍熕熖熴燝燞燵燶爎爘爠爳牗猠獇獤珯琒琻瑡璍璓璤璴瓧瓰瓱瓲瓸瓼甅甮畓畠畩癦癷睵砛砽硓硘硛硧硳硴硸碵碷磗磮礢祍禙禣稤稥穃穒穝穦穯窤窧窽笂笹笽筽箮篐篒簓簯籂籎籡粂粐粩粭糀糘綛緓緕縅縇繌繧纐罀罉罖翶耂聁聓聢聣聺胿脌脦膒舤舿艈艔艝艠苆茐茒茾荢莻萙萞萟萡萢蒅蒊蒏蓃蓙蓜蓞蓤藔藵蘒蘕蘰虄虅虲蛯蝊螦螧螩蟐蟵蠴衐袥袮袰裃裄裇褄褜褝襅襨襷襽覄覅誮謃謉贌贘趰踎躮躵躻躼躾軅軈轌辪辷辻込迌迚迲逧遖遤邜邤郮酛酜釻鈨鈪鈫銯鋢鋲鋴錻錿鍂鍅鎆鎺鎼鎽鎾鏯鏱鏲鐢鐣鑦鑧閊閚閪闁闎闏闧陹霗霻靍鞰韕颪飊駯駲髸魸魹鮖鮗鮘鮱鮲鮴鯂鯎鯏鯐鯑鯱鯲鯳鰘鰚鰰鱛鱩鱪鱰鳰鴫鵆鵇鵈鵤鵥鶍鶎鶑鶫麿
sang5	丧
xie5	些
xin3	伈
zun4	俊鱒
nuan4	偄
nang4	儾齉
r2	儿
er1	兒
cui2	凗慛皠翆
fou2	剻哹紑罘芣裦
qiong1	匔焪穹
suan3	匴
chui4	吹炊諈
pen3	呠翉翸
kuai1	咼喎糩
yue3	哕
mou1	哞
o4	哦
miu1	唒
n3	唔嗯
ng2	唔嗯
ng3	唔嗯
an2	啽玵雸
ka4	喀
pen5	喷
ng4	嗯
n4	嗯
dei1	嘚
o3	嚄
ca4	囃
nan1	囝囡
chang5	场
pan3	坢奤
lun3	埨稐耣
ruan2	堧壖撋
xiong4	夐敻詗诇
zi2	子
ze3	怎
qing5	情
mou4	愗
sun4	愻潠
huang5	慌荒
kang3	慷
qia2	拤
nin3	拰
keng3	挳
kuo3	擃
cao4	操肏襙
san5	散
jin5	斤
pei3	昢琣
men3	暪
nuo3	橠砈
cong4	欉藂謥
qian5	欠
e^1	欸誒诶
e^2	欸誒诶
e^3	欸誒诶
e^4	欸誒诶
ta5	沓
zhui3	沝
hun3	混睔鯶
neng4	濘
shuang4	灀
dian5	点
rou3	煣粈糅鍕
teng1	熥膯鼟
run1	犉
chuo2	犳
nou2	獳羺
run2	瞤
zhou5	碡
zhun4	稕
huai1	竵
ping3	絣
rao5	绕
chuo5	绰
gou2	耈
chuai2	膗
reng4	芿
nie2	苶
lan5	蓝
gun1	裩
lai3	襰
pian3	覑諞谝
cang4	賶
qie5	趄
ang3	軮
suo4	逤
lue2	鐚
tun5	飩饨
yiao1	鴁
nu1	鴑
rong4	鴧
nen1	黁
qui2	鼽
hou1	齁
