ling2	〇令伶凌刢呬囹坽堎夌姈婈孁怜掕昤朎柃棂棱櫺欞泠淩澪灵燯爧狑玲琌瓴皊睖砱碐祾秢竛笭紷綾绫羚翎聆舲苓菱蕶蘦蛉衑裬詅跉軨輘酃醽鈴錂铃閝陵零霊霛霝靈駖魿鯪鲮鴒鸰鹷麢齡齢龄龗
yi1	一伊依医吚咿噫壱壹夁嫛嶬弌揖椅檹欹殹毉洢溰漪燚猗瑿祎禕稦竓竕竡繄蛜衣衤譩郼醫銥铱陭餏鷖鹥黟黳
ding1	丁仃叮帄玎町甼疔盯耵虰酊釘钉靪
zheng1	丁争佂埩姃峥崢征徰徴徵怔挣掙揁正炡烝爭狰猙症癥眐睁睜筝箏篜聇蒸諍踭鉦錚鏳鑁钲铮鬇鯖鲭
kao3	丂拷攷栲槀洘烤熌燺稁考薧鮳
qi1	七倛僛凄咠唭嘁妻娸徛悊悽慼慽戚捿攲朞期柒栖桤桼棲榿槭欹欺沏淒溪漆磩紪緀緝缉萋諆谿踦蹊郪霋顣魌鶈鸂
shang4	丄上仩凃姠尙尚爙緔绱銄
shang3	丄上垧扄晌賞赏鑜
xia4	丅下厦吓唬嚇夏夓廈懗暇欱疜睱罅芐鏬鶷
none0	丆丷乄乊乛乤乥乧乬乮乯乲乺乻乼乽亇亪亽仒佦佨侤俧倿傦儏兯兺冧凧凩凪匁匂匇厁厑厼叾呚哖哘哛唜唟唥啹喸嗭嗴嘊嘥噺嚑嚒嚡囎囕囖圦圷圸垈垊垪垰垳埖堏堒塀塰墛墹壗壪壭夈夑夞夻奍娐婔婮婲媈媘媫嫲嬄嬜嬫嬳嬶孧尡屗屶屷岃岼岾峅峠崊嵵嵶嵻嶶嶿巪巬巭巼幉幥庒廤廭彁彅徔徚怺怽怾恷愥愱慐懳扖抣挘挧捤掵掶掹揻揼摗撶擜擝攚敾旀旕暃曕曢朑朥朰杁杢杣杤枠枤柨栃栆栍栶桛桝桞梺梻椚椛椡椣椦椧椨椩椬楾榁榊榋榌槝槡樭樮樰橲橳橴橵橸橺橻檲櫊櫔櫤櫦櫵櫷欌欍欕欟歄歚殝毜毝毟毮毶氞汢汣汼洜浌涥渏湪湭溄溊溋潈潉潱澝濸瀭瀮灐灜灳炿烥烪烮焁焑焒焹焽焾焿煀煯煶煷熍熕熖熴燝燞燵燶爎爘爠爳牗猠獇獤珯琒琻瑡璍璓璤璴瓧瓰瓱瓲瓸瓼甅甮畓畠畩癦癷睵砛砽硓硘硛硧硳硴硸碵碷磗磮礢祍禙禣稤稥穃穒穝穦穯窤窧窽笂笹笽筽箮篐篒簓簯籂籎籡粂粐粩粭糀糘綛緓緕縅縇繌繧纐罀罉罖翶耂聁聓聢聣聺胿脌脦膒舤舿艈艔艝艠苆茐茒茾荢莻萙萞萟萡萢蒅蒊蒏蓃蓙蓜蓞蓤藔藵蘒蘕蘰虄虅虲蛯蝊螦螧螩蟐蟵蠴衐袥袮袰裃裄裇褄褜褝襅襨襷襽覄覅誮謃謉贌贘趰踎躮躵躻躼躾軅軈轌辪辷辻込迌迚迲逧遖遤邜邤郮酛酜釻鈨鈪鈫銯鋢鋲鋴錻錿鍂鍅鎆鎺鎼鎽鎾鏯鏱鏲鐢鐣鑦鑧閊閚閪闁闎闏闧陹霗霻靍鞰韕颪飊駯駲髸魸魹鮖鮗鮘鮱鮲鮴鯂鯎鯏鯐鯑鯱鯲鯳鰘鰚鰰鱛鱩鱪鱰鳰鴫鵆鵇鵈鵤鵥鶍鶎鶑鶫麿
wan4	万仴卍卐忨捥玩綄翫腕萬蔓蟃貦贎踠鎫
mo4	万冐冒劰嗼嘜嘿嚜圽塻墨妺嫼寞帞慔抹昩暯末枺歾歿殁沒没沫湐漠爅狢獏瘼皌眜眽瞙砞磨礳秣粖縸纆耱脈脉膜茉莈莫萬蓦藦蛨蟔衇袹覛謩貃貉貊貘銆鏌镆陌霢靺鞆驀鬕魩默黙
zhang4	丈仗墇嶂帐帳幛扙杖涨涱漲痮瘬瘴瞕粀胀脹賬账障
san1	三叁參叄嘇弎攕毵毿犙鬖
ji1	丌乩其几击刏剞勣叽咭唧喞嗘嘰圾基墼奇姫姬尐居屐峜嵆嵇幾撃擊朞期机枅樍機櫅欚毄激犄玑璣畸畿癘癪矶磯禨积稘稽積竒笄筓箕簊緝績绩缉羁羇羈耭聻肌芨萁虀蛣襀覉覊觭諅譏譤讥賫賷赍跡跻蹟躋躸迹銈鐖鑇鑙隮雞霙鞿韲飢饑饥鰿鳮鶏鷄鸄鸡齍齎齏齑
bu4	不佈勏咘埔埗埠布怖悑捗步歨歩瓿篰簿荹蔀部郶鈈鈽钚餢
bu2	不醭
fou3	不否殕缶缹缻雬鴀
yu3	与予伛俁俣偊傴匬噳圄圉宇寙屿嶼庾懙敔斔斞楀瑀瘐祤禹窊窳篽羽聥與萭蘌螤語语貐鄅酑雨齬龉
yu4	与俼叞吁喅喐喩喻噊圫域堉妪嫗寓尉峪嶎庽彧御忬悆悇惐愈慾戫昱栯棛棜棫櫲欎欝欥欲毓浴淢淯滪潏澦灪焴煜熨燏燠爩狱獄獝玉琙瘉癒矞砡硲礇礖礜禦禺秗稢稶穥籞籲粥糓緎繘罭聿肀育與芋芌茟菀萮蒮蓣蓹蔚蕷薁蜟蜮袬裕誉語諭譽语谕谷豫軉輍逳遇遹郁醧鈺銉鋊錥鐭钰閾阈隩雨霱預预飫饇饫馭騟驈驭鬰鬱鬻魊鳿鴥鴪鵒鷸鹆鹬黦
yu2	与予于亐伃余俞兪唹堣堬妤娛娯娱媀嬩崳嵎嵛愉愚扵揄於旟杅桙楡楰榆欤歈歟歶渔渝湡漁澞狳玗玙瑜璵畬畭盂睮硢禺窬竽籅緰羭腴臾舁舆艅茰萸蕍蘛虞蝓螸衧褕覦觎諛謣谀踰輿轝逾邘鄃釪鍝隃隅雓雩雽餘馀骬髃魚魣鮽鰅鱼鵌鷠鸆鸒齵
mian3	丏俛偭免冕勉勔喕娩愐汅沔渑湎澠眄絻緬缅腼靦鮸麫黽黾
gai4	丐乢匃匄戤摡概槩槪溉漑瓂盖芥蓋鈣钙魪
chou3	丑丒侴吜杻杽瞅矁莥醜魗
zhuan1	专剸叀塼嫥専專瑼甎砖磚篿耑膞蟤鄟顓颛鱄鷒
qie3	且
ju1	且俱倶凥刟娵居崌抅拘拠据掬揟據斪椐毱沮泃涺狙琚疽痀眗罝腒艍苴葅蛆蜛裾諊趄跔踙車輋车鋦鋸锔锯雎鞠鞫駒驹鮈鯺鴡鶋
pi1	丕伾劈匹噼坏坯壊壞怌怶憵批披抷旇炋狉狓砒磇礕秛秠紕纰翍耚被豾辟邳釽鈹鉟銔铍闢霹駓髬鴄
shi4	世丗亊事仕似佀使侍冟势勢卋卶叓呩嗜噬士奭媞嬕室峙崼市式弑弒徥恃戠戺拭揓是昰枾柹柿氏澨烒眂眎睗示礻筮簭翨舐舓莳蒔螫衋褆襫視视詍試誓諟諡謚識试谥貰贳跩軾轼适逝適遾釈释釋鈰鉃鉽銴鋬铈飾餙餝饰齛
qiu1	丘丠亀偢坵媝恘楸湫秋秌穐篍緧萩蓲蚯蝵蟗蠤趥邱鞦鞧鰌鰍鱃鳅鶖鹙龜龝龟
bing3	丙屏庰怲抦昞昺柄棅炳琕眪禀秉稟窉苪蛃邴鈵鉼陃鞞餅餠饼
ye4	业亱偞僷叶咽哗嘩墷夜射嶪嶫忦拽掖擛擪擫晔曄曅曗曳枼業殗殜液澲烨煠燁皣瞱瞸腋葉謁谒邺鄴鍱鎑鐷靥靨頁页餣饁馌驜鵺鸈
cong2	丛从叢婃孮従徖從悰慒樷淙漎潀灇爜琮誴賨賩錝
dong1	东倲冬咚埬娻岽崠崬昸東氡氭涷炵笗苳菄蝀鯟鶇鸫鼕
si1	丝俬偲凘厮厶厷司咝嘶噝媤廝思恖撕斯楒榹泀澌燍磃禗私絲緦缌罳蕬蛳蜤螄蟖蟴覗謕鉰鋖鍶锶颸飔騦鷥鸶鼶
cheng2	丞乗乘呈城埕堘塍塖娍宬峸惩憕懲成承挰掁揨晟枨棖椉橙洆澂澄瀓珵珹畻盛程窚筬絾脀脭荿裎誠诚郕酲鋮铖騬
diu1	丟丢乣銩铥
liang3	両两俩倆兩唡啢掚緉脼蜽裲魉魎
you3	丣卣友岰庮有梄槱泑湵牖禉羐羑聈脜苃莠蜏酉銪铕黝
yan2	严厳嚴圤塩壛壧妍姸娫娮孍岩嵒嵓巌巖巗延揅昖楌檐櫩沿湺炎狿琂癌盐研硏碞礹筵簷綖芫莚葕蔅虤蜒言訁詽讠郔鈆鉛铅閆閰閻闫阎阽顃顏顔颜鹽麙麣
bing4	並併倂偋傡寎并幷摒柄栤病竝靐鮩鵧
sang1	丧喪枽桑桒
sang4	丧喪
sang5	丧
shu4	丨侸俞倏儵兪凁墅尌庶庻恕戍捒数數曙术束树樜樹沭漱潄澍濖疏竖竪絉署翛腧蒁術裋豎述鉥錰鏣鶐
jiu1	丩勼啾揂揪揫朻樛湫牞究糺糾纠萛觓赳轇阄鬏鬮鳩鸠
ge4	个個各嗰硌箇虼鉻铬鶮
ge3	个各合哿擖盖笴舸葛葢蓋騔魺
ya1	丫压呀哑唖啞圧垭埡壓孲庘押桠椏煆雅鴉鴨鵶鸦鸭
qiang2	丬墙墻嫱嬙廧弜強强彊樯檣漒爿牆艢蔃蔷薔蘠軖
pan2	丬噃媻幋搫槃瀊爿盘盤磐磻縏胖般蒰蟠跘踫蹒蹣鎜鞶
zhong1	中伀刣妐幒彸忠忪柊汷泈潨炂煄盅籦終终舯蔠螽衳衷蹱鈡銿鍾鐘钟锺鴤
zhong4	中乑仲众偅堹妕媑尰湩狆眾种種筗緟茽蚛衆衶諥重
ji3	丮几剞妀己幾戟挤掎撠擠泲济濟穖給纪给脊虮蟣革魕魢鱾麂
jie4	丯介价価借吤唶堺屆届岕庎徣悈戒楐犗玠琾界畍疥痎砎祴紒繲艥芥藉蚧褯解觧誡诫躤鎅骱魀
feng1	丰仹偑僼凨凬凮妦寷封峯峰崶捀枫桻楓檒沣沨灃烽熢犎猦疯瘋盽砜碸篈莑葑蘴蜂蠭諷豊豐鄷酆鋒鏠锋靊風飌风麷
guan4	丱冠悹悺惯慣掼摜樌毌泴涫潅灌爟瓘盥矔礶祼罆罐観觀观謴貫贯遦鏆鑵雚鱹鸛鹳
chuan4	串剏汌玔賗釧钏
chan3	丳产冁刬剗剷啴嘽囅嵼幝摌旵浐滻灛燀產産簅繟蒇蕆諂譂讇谄鏟铲閳闡阐骣
lin2	临僯厸啉壣嶙惏斴晽暽林淋潾瀶燐獜琳璘甐疄痳瞵矝碄磷秘箖粦粼繗罧翷臨蹸轔轥辚遴邻鄰鏻隣霖驎鱗鳞麐麟
zhuo1	丵倬卓拙捉晫桌棁棹涿焯穛
zhu3	丶主嘱囑壴孎属屬拄斸欘渚濐煑煮眝瞩矚砫罜著褚詝貯陼麈
dian3	丶典嚸奌婰点琠碘蕇踮錪點
wan2	丸刓婠完岏抏汍烷玩琓紈纨芄頑顽
dan1	丹儋勯匰单単單嚪妉媅担擔殚殫甔瘅癉眈砃箪簞耼耽聃聸襌躭郸鄲酖頕
wei2	为危唯囗囲围圍圩嵬巍帏帷幃微惟桅欈沩洈涠湋潍潙潿濰濻瀢為爲琟癓矀維维薇覹违違鄬醀鍏闈闱霺韋韦鮠
wei4	为亹位偽卫味喂媦嬒尉徻慰懀未渭為熭爲犚犩猬璏畏硙磑穌緭罻胃苿菋蔚薉藯蘶蜼蝟螱衛衞褽謂讆讏谓贀躗躛軎轊遗遺錗鏏霨餧餵魏鮇鳚
jing3	丼井儆刭剄宑憬憼景暻汬烴燛璟璥穽肼蟼警阱頚頸颈
dan3	丼亶刐担掸撢撣擔澸玬瓭疸瘅癉紞胆膽衴賧赕黵
li4	丽例俐俪傈儮儷凓利力励勵历厉厤厯厲吏呖唎唳嚦囇坜塛壢娳婯屴岦峲巁悧悷慄戻戾搮攦攭斄暦曆曞朸枥栎栗栛栵棙檪櫟櫪欐歴歷沥沴浰涖溧濿瀝爄爏犡猁珕琍瑮瓅瓑瓥疠疬痢癘癧皪盭矋砅砬砺砾磿礪礫礰禲秝立笠筣篥粒粝糲綟纅脷苈苙茘荔莅莉蒞藓藶蘚蚸蛎蛠蜧蝷蠇蠣蠫觻詈讈赲跞躒轢轣轹郦酈釙鉝隶隷隸雳雴靂靋鬁鬲鱱鱳鳨鴗鷅鷑麗麜
li2	丽刕剓剺劙厘喱嚟囄嫠孋孷廲悡攡梨梩梸棃樆氂漓漦灕犁犂犛狸猍璃瓈睝离穲篱籬粍粚糎縭缡罹艃菞蓠蔾藜蘺蜊蟍蟸蠡褵謧貍邌醨釐鋫錅鏫鑗離騹驪骊鯬鱺鲡鵹鸝鹂麗麶黎黐黧
ju3	举咀弆挙擧枸柜椇楀榉櫃櫸欅沮矩窼竘筥舉莒蒟蝺袓跙踽齟龃
pie3	丿撇苤鐅
fu2	乀仏伏佛俘凫刜匐咈咉垘夫孚岪巿帗幅幞弗彿怫懯払扶拂昲服枎枹柫桴棴氟沷洑浮涪澓炥烰玸琈甶畉癁砩祓福稃符笰紱紼絥綍縛绂绋罘翇艀艴芙芾苻茀茯莩菔葍虙蚨蜉蝠袚袱諨踾輻辐郛鉘鉜韍韨颫髴鮄鳧鳬鴔鵩鶕鶝黻
yi2	乁仪侇儀冝匜咦圯夷姨宐宜宧寲峓嶷巸弬彛彜彝彞怡恞悘扅暆杝柂栘桋椸歋沂沶洟熪珆瓵疑痍眙眤眱移箷簃羠胰苐荑萓虵蛇蛦螔衪袘袲觺訑詒誼謻讉诒貤貽贻跠迆迤迻遗遺酏鈘鈶銕頉頤頥顊颐飴饴鮧鸃
yi4	乂义亄亦亿仡伇伿佚佾俋億兿刈劓劮勚勩呓呭呹唈嗌噫囈圛垼埶埸墿奕嫕嬑嬟寱屹峄嶧帟帠幆廙异弈弋役忆怈怿悒悥意憶懌懿抑抴挹捙掖撎敡斁易晹曀曎曳杙枍枻栧棭榏槷槸檍欭歝殔殪毅泆洂浂浥浳液湙溢潩澺瀷炈焲熠熤熼燡燱獈玴異疫痬瘗瘞瘱癔益瞖秇穓竩緆縊繶繹绎缢羛義羿翊翌翳翼肄肊腋膉臆艗艺艾芅苅蓺薏藙藝蘙虉蛡蜴螠衣袣裔裛褹襼訲訳詣誼謚譯議讛议译诣谊豙豛豷跇軼轶逸邑酏醳醷釴鈠鎰鐿镒镱阝阣隿霬靾鞥顡食饐駅驛驿骮鯣鷁鷧鷾鹝鹢黓齸
ai4	乂伌僾叆哎唉嗌嗳噯堨塧嫒嬡愛懓懝暧曖欸濭爱瑷璦皧瞹砹硋碍礙艾薆譪賹鑀隘靉鱫鴱
nai3	乃哪奈奶妳嬭廼氖氝疓艿迺釢
jiu3	久乆九奺灸玖糾紤舏赳酒镹韭韮
tuo1	乇侂侻咃堶托扥拕拖挩捝汑沰涶矺脫脱託詑讬饦馲魠
me5	么麼麽
ma5	么吗嗎嘛蟆
yao1	么吆喓夭妖幺楆祅約约腰葽要訞邀
zhi1	之倁卮只吱巵指掷搘支枝枳栀梔椥榰氏汁汥泜知祇祗祬秓秖秪竓竕綕織织肢胑胝脂芝蜘衹衼跖隻馶鳷鴟鴲鼅
wu1	乌兀剭呜嗚圬媉屋巫弙恶惡於杇歍汙汚污洿烏窏箼腛螐誣诬邬鄔鎢钨陓鰞鴮
wu4	乌兀务務勿卼噁坞埡堊塢奦婺寤屼岉嵍忢恶悞悟悪悮惡戊扤敄旿晤杌沕溩烏焐煟熃物痦矹窹粅芴蓩蘁誤误逜遻鋈阢隖雾霚霧靰騖骛鰞鶩鹜齀
zha4	乍吒咋咜咤搾柞柵栅榨溠灹炸痄簎蚱蜡蝋蠟詐诈醡鮓
hu1	乎匢匫吰呼唿啒嘑垀寣峘幠忽恗惚戏戯戲昒曶欻歑歘泘淲淴滹烀烼糊膴苸虍虖謼軤轷雐餬
fa2	乏伐傠垡姂栰栿牫疺笩筏罚罰罸茷藅閥阀
le4	乐仂勒叻哷埒忇扐楽樂氻泐玏砳竻簕肋艻阞頱鰳鳓
yue4	乐刖妜岄岳嶽恱悅悦戉抈捳曜月枂栎楽樂樾檪櫟泧瀹爚狘玥礿禴篗籆籥籰粤粵耀藥蘥蚎蚏說説说越趯跀跃躍軏鈅鉞鑰钥钺閱閲阅鸑鸙龠龥
ping1	乒俜娉焩砯聠覮頩
pang1	乓滂磅胮膀膖
qiao2	乔侨僑喬嘺嫶峤嶠嶣憔敿桥槗樵橋燆癄瞧硚礄簥翘翹荞蕉蕎藮譙谯趫鐈鞒鞽顦
hu3	乕唬汻浒滸琥萀虎虝許
hu4	乕互冱冴嚛婟嫭嫮岵帍弖怘怙戶户戸戽扈护摢昈枑楛槴沍沪滬熩瓠祜笏簄糊綔臛蔰虎虝謢護豰鄠頀餬鳠鳸鸌鹱
guai1	乖宔掴摑
sheng4	乗乘剩剰勝圣墭嵊晟晠椉榺琞盛聖胜蕂貹賸
yi3	乙以倚偯尾崺已庡扆掜旑旖晲椅檥矣礒笖肔胣舣艤苡苢蚁蛾螘蟻衣輢轙迆迤逘酏釔鉯钇陭顗鳦齮
yin3	乚听吲尹嶾廴引檃櫽殷淾濦瘾癮磤粌紖縯蘟蚓螾讔趛鈏隐隠隱靷飮飲饮馻
mie1	乜吀咩孭羋
nie4	乜啮喦嗫噛嚙囁囓圼孼孽嵲巕帇敜枿棿櫱涅湼疌痆篞糱糵聂聶臬臲菍蘖蘗蠥踂蹑躡錜鎳鑷钀镊镍闑陧隉顳颞齧齩
qi3	乞企启呇唘啓啔啟婍屺岂敧晵杞棨槣玘盀稽綮綺绮芑芞裿諬豈起邔闙
ye3	也冶吔嘢埜壄漜野
xi2	习媳嶍席息惜昔棤椺槢檄欯漝焟焬熄獥瘜習蒠蓆薂蝷袭裼褶襲覡觋謵趘錫鎴隰霫飁騽鰼鳛
xiang1	乡厢啌廂忀欀湘瓖相箱緗纕缃芗葙薌襄郷鄉鄊鄕鑲镶香驤骧鱜麘
shu1	书倏倐叔圕姝尗抒摅摴攄書杸枢梳樗樞橾殊殳毹淑疋疎疏祋紓綀纾舒菽蔬藲踈軗輸输陎鵨
shi3	乨使兘史始宩屎矢笶豕鉂駛驶
nang1	乪嚢囊囔
jia1	乫伽佳傢加嗧嘉夹夾家幏拁挟枷毠泇浃浹犌猳珈痂笳縀耞腵茄葭袈豭貑跏迦鉫鎵镓鴐麚
shi2	乭什兙十喰埘塒实実寔實射峕拾提时旹時榯湁湜溡炻石碩祏竍竕莳蒔蚀蝕遈鉐食飠饣鰣鲥鼫鼭
mai3	买嘪荬蕒買鷶
luan4	乱亂薍釠
ru3	乳侞女擩汝肗辱
xi3	乴匚喜囍屣徙憘憙敼暿枲洗漇狶玺璽矖禧簁縰纚葈葸蓰蟢諰蹝躧鉩銑铣霼鰓鱚
yan3	乵俨偃儼兖兗剡匽厣厴夵奄姶嵃嶖巘巚弇惔愝戭扊抁掩揜曮棪椼檿沇渰渷演琰甗眼硽罨萒蝘衍裺褗躽遃郾酓隒馣魇魘鰋鶠黡黤黭黶鼴鼹鼽龑
fu3	乶俌俯冹嘸府弣抚拊捬撫斧暊滏焤父甫盙秿簠脯腐腑蚥蜅軵輔辅郙釜釡頫鬴鯆黼
sha1	乷刹帴挲摋杀杉榝樧殺沙煞猀痧砂粆紗纱莎蔱裟鎩铩髿魦鯊鯋鲨
na3	乸哪那雫
gan1	乹乾亁凲咁坩尲尴尵尶尷嵅干幹忓攼杆柑泔玕甘疳矸竿筸粓肝苷虷蜬迀酐鳱
qian2	乹乾仱偂前姏媊岒忴扲拑掮揵榩歬漧潛潜濳灊燂犍瓩箝荨葥蕁虔蚙軡鈐鉗銭錢钤钱钳騚鬈鬵鰬鳹黔黚
zhi4	乿偫制劕厔垁娡寘峙崻帙帜幟庢庤彘徏徝志忮憄懥挃挚掷搱摯擲旘智栉桎梽櫍櫛治洷淛滍滞滯潌炙熫狾猂猘畤疐痔痣瘈知礩祑秩秲稚稺穉窒筫紩緻置翐胵腟膣至致臸芖虒蛭螲袟袠製覟觗觢觯觶誌識识豑豒豸貭質贄质贽跱踬躓輊轾迣遰郅銍鋕鑕铚锧陟陦隲雉駤騭騺驇骘鴙鴩鷙鸷
gui1	亀傀圭妫媯嫢嬀帰归摫椝槻槼歸溈珪瑰璝瓌皈硅窐膭袿規规邽郌閨闺鬶鬹鮭鲑龜龟
jun1	亀军君囷均姰桾汮皲皸皹碅筠箟莙菌蚐袀覠軍鈞銁銞钧頵鮶鲪麇麏麕龜龟
lin3	亃凛凜廩廪懍懔撛檁檩澟癛癝綝菻
jue2	亅倔傕僪决刔劂厥噱嚼堀孒孓屩屫崛崫嶥弡彏憰戄抉挗捔掘撧攫斍桷橛橜欔欮殌氒決焆焳熦爑爝爴爵獗玦玨珏瑴疦瘚矍矡砄穱絕絶绝脚臄芵蕝蕨蚗蟨蟩覐覚覺觉角觖觼訣譎诀谲谻赽趹踋蹶蹷躩逫鈌鐍鐝钁镢鱊鴃鷢龣
le5	了餎饹
liao3	了尞憭暸潦燎瞭蓼蟟鄝釕钌
liao4	了尥尦廖撂撩料炓燎爒瞭窲蟉釕鐐钌镣
er4	二佴刵咡弍弐樲毦眲聏衈誀貮貳贰
chu4	亍俶傗儊処处怵憷拀搐敊斶欪歜泏滀琡畜矗竌竐絀绌臅荲處触觸詘豖踀遚鄐閦黜
kui1	亏刲噅岿巋悝盔窥窺茥藈蘬虧鍷闚鞹
yun2	云伝勻匀员員妘愪昀枃榅榲橒沄涢溳澐熅畇眃秐筠筼篔紜縜纭耘耺芸荺蒷蕓貟贠郧鄖鋆雲饂
qi2	亓亝俟其剘圻埼墘奇岐岓崎嵜帺愭懠掑斉斊旂旗期枝棊棋檱櫀歧淇濝猉玂琦琪璂畁畦疷碁碕祁祇祈祺禥稘竒竢簱籏粸綦綨纃翗耆脐臍艩芪荠萁萕蕲薺藄蘄蚑蚔蚚蛴蜝蜞蠐衹跂踑軝迉鄿釮錡錤锜靔頎颀騎騏骐骑鬐鬿鮨鯕鰭鲯鳍鵸鶀麒麡齊齐
wu3	五仵伍侮倵儛午啎妩娬嫵嵨庑廡忤怃憮捂摀橆武潕牾玝珷瑦甒碔舞躌迕鄥鵡鹉
si4	亖伺似佀俟儩兕喰嗣四姒娰孠寺巳杫柶汜泗泤洍涘瀃牭祀禩竡竢笥耜肂肆蕼貄賜釲鈻食飠飤飼饣饲駟驷
sui4	亗埣嬘岁嵗旞檅檖歲歳澻煫燧璲瓍睟砕碎祟禭穂穗穟粋繀繸襚誶譢谇賥遂邃鐆鐩隧
gen4	亘亙艮茛
geng4	亙堩暅更
ya4	亚亜亞俹劜压圠圧垭壓娅婭挜揠氩氬猰砑稏窫聐襾訝讶軋轧迓錏铔齾
xie1	些嗋揳楔歇猲蝎蠍褉
xie5	些
ya3	亞匹厊哑啞庌掗疋痖瘂瞧蕥雃雅
ji2	亟亼伋佶偮卙即卽及叝吃吉堲塉姞嫉寂岌嵴嶯庴彶忣急戢揤擊擮极棘楖楫極槉橶殛汲湒漃潗濈狤疾瘠礏笈箿籍級级耤脊膌莋蒺蓻蕀蕺藉蝍螏衱襋觙诘踖蹐輯轚辑郆鈒銡鍓鏶集雦雧霵革鞊鴶鶺鹡
qi4	亟企呮噐器夡契妻弃忔愒憇憩摖斉斊暣栔棄槭欫气気氣汔汽泣湆湇炁焏甈盵矵砌碛碶磜磧礘綥緝葺蟿訖諿讫迄鏚鼜齐
tou2	亠坄头投牏牐酘頭骰
wang2	亡亾仼兦彺忘王芒蚟
wu2	亡俉兦吳吴吾呉唔娪峿巫捂无梧毋洖浯無牾珸璑瞴祦禑芜茣莁蕪蜈蟱誈誣譕郚鋘鋙铻鯃鵐鷡鹀麌鼯
kang4	亢伉匟囥抗炕犺砊邟鈧钪閌闶
ta4	亣傝嗒嚃嚺崉拓挞搨撻榻橽毾沓涾溻漯澾濌狧獺羍誻譶踏蹋蹹躂躢迖遝遢錔鎉鑉闒闥闼阘鞜鞳鮙鰨龖龘
jiao1	交僬嘄姣娇嬌峧嶕憍憿教椒浇澆焦燋礁穚胶膠膲艽芁茭茮蕉虠蛟蟂蟭詨跤郊鐎驕骄鮫鱎鲛鴵鵁鷍鷦鷮鹪
hai4	亥嗐害氦絯餀饚駭骇
heng1	亨亯哼悙脝諻
mu3	亩姆姥娒峔拇母牡牳畆畒畝畞畮砪胟鉧
xiang3	享响嶑想晑響飨餉饗饟饷鮝鯗鱶鲞
jing1	京亰兢坕坙婛巠惊旌旍晶泾涇猄睛秔稉粳精経經经聙腈茎荆荊莖菁驚鯨鲸鵛鶁鶄麖麠黥鼱
ting2	亭停婷嵉庭廷朾楟榳渟筳綎聤莛葶蜓蝏諪邒閮霆鯅鼮
liang4	亮倞凉哴喨悢晾涼湸諒谅踉輌輛辆量鍄靓靚
qin1	亲侵儬媇寴嵚嶔欽瀙綅衾親誛钦駸骎鮼
qin5	亲
qing4	亲凊庆慶掅殸汫漀碃磘磬箐綮罄罊親謦鑋靘
bo2	亳伯侼僰勃博孛嶏帛愽懪挬搏敀柏栢桲檗欂泊浡渤煿牔犱犻猼百礡礴箔簙糪胉脖膊舶艊苩葧蔔薄袯襮謈踄踣郣鉑鋍鎛鑮钹铂镈餺馎馞駁駮驳骲髆魄鲌鵓鸔鹁
you4	亴佑侑又右哊唀囿姷宥峟幼有柚牰狖祐糿蚴誘诱貁迶酭釉鴢鼬
xie4	亵伳偰写卨卸塮契妎娎媟屑屟屧嶰廨徢懈斺暬械楔榍榭泄泣泻洩渫澥瀉瀣灺焎燮爕獬疶祄禼糏紲絏絬緤绁缷薤蟹蠏衸褻解觧謝谢躞躠邂鞢韰駭駴骱齘齥
dan4	亶但僤啖啗啿嘾噉帎幨弹弾彈惮憚憺担擔旦暺柦殫氮沊泹淡潬澹灗狚疍瘅癉癚石窞腅舕萏蛋蜑觛誕诞霮饏馾駳髧鴠
lian2	亷劆匲匳嗹噒奁奩奱嫾嬚帘廉怜慩憐梿槤櫣涟溓漣濂濓熑燫璉磏稴簾籢籨縺翴联聨聫聮聯臁莲蓮薕螊蠊裢褳覝謰譧蹥连連鎌鐮镰鬑鰱鲢
duo3	亸哚嚲垛垜埵挅挆朵朶痑綞缍趓躱躲軃鬌
wei3	亹伟伪偉僞儰唯喡壝委娓寪尾峗崣嵔徫愇斖暐梶椲洧浘炜煒猥玮瑋痏痿硊磈緯纬腲艉芛苇荱萎葦蒍蓶蔿薳蘤蜲諉诿踓鍡隗韑韙韡韪頠颹骩骪骫鮪鲔
ren2	人亻仁任壬忈忎朲秂紝芢鈓銋魜鴹
shen2	什甚神
she2	什佘折揲甚舌虵蛇蛥鉈鍦铊闍阇
ze4	仄侧側夨庂昃昗汄稄
jin3	仅侭僅儘卺厪堇墐尽巹廑慬槿漌瑾盡紧緊菫覲謹谨錦锦饉馑
jin4	仅伒侭僅僸儘凚劲勁噤嚍妗嫤嬧寖尽搢晉晋歏殣浕浸溍濅濜烬燼瑨璡璶瘽盡祲禁縉缙肵荩蓳藎覲觐賮贐赆近进進靳齽
pu1	仆僕噗扑抪撲擈潽痡瞨舗鋪铺陠
pu2	仆僕匍墣朴樸濮璞穙箁纀脯莆菐菩葡蒱蒲襆襥蹼轐酺鏷镤
chou2	仇俦儔嚋嬦帱幬惆愁懤栦椆燽畴疇皗稠筹籌紬絒綢绸菗薵裯詶讎讐踌躊酧酬醻雔雠鯈
qiu2	仇俅僋厹叴囚崷巯巰扏朹梂殏毬求汓泅浗渞煪犰玌球璆皳盚紌絿肍脙苬莍虬虯蛷蝤裘觩訄訅賕赇逎逑遒酋醔釚銶鮂鯄鰽
ba1	仈八叭吧哵夿岜巴扒捌朳玐疤笆粑紦羓芭豝釟魞鲃
zhang3	仉僟兏掌涨漲礃長镸长鞝
jin1	今兓埐嶜巾惍斤津浸珒琎瑧矜禁筋紟荕菳衿襟觔金釒钅鹶黅
bing1	仌傡兵冫冰并掤栟梹槟檳氷竝
reng2	仍礽辸陾
cong1	从匆囪囱從悤暰枞棇樅樬漗焧熜燪瑽璁瞛篵繱聡聦聪聰苁葱蓯蔥蟌鍐鏦騘驄骢
fo2	仏佛坲髴
san3	仐伞佡傘散糁糂糝糣糤繖鏾鐁霰饊馓
lun2	仑伦侖倫嗧囵圇婨崘崙惀抡掄棆沦淪碖綸纶腀菕蜦論论踚輪轮錀陯鯩
cang1	仓仺伧倉傖凔嵢沧滄舱艙苍蒼螥鶬鸧
zi3	仔吇呰啙姉姊子杍梓榟滓矷秄秭笫籽紫耔胏芓茈虸訾訿釨
zai3	仔儎宰崽縡載载
zi1	仔兹吱呲咨嗞姕姿孖孜孳孶崰嵫栥椔淄湽滋澬玆礠禌秶稵粢紎緇缁茊茲著葘蟕蠀觜訾諮谘貲資赀资趑趦輜輺辎鄑鈭錙鍿鎡锱镃頾頿髭鯔鰦鲻鴜鶅鶿鼒齍齜龇
ta1	他塌她它愵溻牠祂禢褟趿踏遢釶鉇鉈铊
fu4	付偩傅冨副咐坿复妇姇婏婦媍富峊復服椱榑洑父畐祔稪竎緮缚胕腹萯蕧蚹蛗蝜蝮袝複褔覆訃詂讣負賦賻负赋赙赴輹鍑鍢阜阝附陚馥駙驸鮒鰒鲋鳆
xian1	仙仚僊僲先嘕奾嬐孅尠屳廯忺憸掀暹杴枮氙澖灦珗祆秈籼繊纎纖纤苮莶蓒薟褼襳訮跹蹮躚酰銛鍁铦锨韯韱馦鮮鱻鲜
cha4	仛侘刹剎叉奼姹岔差杈汊紁衩訍詫诧
hong2	仜垬妅娂宏宖峵弘彋汯泓洪浤渱潂灴玒玜瓨硔竑竤篊粠紅紘紭綋红纮翃翝耾舼苰荭葒葓蕻虹訌谹谼鈜鉷鋐閎闳霟鞃鴻鸿黉黌
tong2	仝佟侗僮勭同哃垌峂峒峝庝彤晍曈朣桐橦氃浵潼烔烕燑爞犝獞眮瞳砼秱穜童粡絧罿膧艟茼蕫詷迵酮鉖鉵銅铜餇鮦鲖鼨
ren4	仞仭任刃刄妊姙屻恁杒梕牣牨紉絍纫纴肕葚衽袵訒認认讱賃軔軠轫靫靭靱靹韌韧飪餁饪鵀
qian1	仟佥僉儙兛千圱圲奷婜岍嵌悭愆慳扦拪掔搴撁攐攑攓杄檶櫏欦汘汧牵牽竏竓签箞簽籖籤粁羥臤芊蚈褰諐謙譣谦谸迁遷釺鉛鐱钎铅阡韆顅顩騫骞鬜鬝鵮鹐麉
gan3	仠感擀敢杆桿橄澉皯盰秆稈衦贑赶趕鱤鳡
ge1	仡割咯哥圪屹戈戓戨搁擱歌渮滒疙紇纥肐胳袼謌鎶鴚鴿鸽麧
di2	仢唙嘀嚁嫡廸敌敵梑涤滌潪犒狄的笛篴籴糴翟芽苖荻蔋蔐藋藡覿觌豴蹢迪鏑镝靮頔鸐
dai4	代叇埭大岱帒带帯帶廗待忕怠戴曃柋殆汏瀻玳瑇甙簤紿緿绐艜袋襶貸贷跢蹛軚軩轪迨逮酨霴靆骀黛黱
ling4	令另呤炩
ling3	令岭岺嶺彾袊阾領领
chao4	仦仯耖觘
chang2	仧倘偿償兏嘗嚐场場塲嫦尝常徜瑺瓺甞粻肠腸膓苌萇裳鋿鏛長镸长鱨鲿
sa1	仨挲撒
mu4	仫募坶墓幕幙恈慕暮木楘毣沐炑牟牧目睦穆苜莯蚞鉬钼雮霂鞪鶩
men5	们們
men2	们們扪捫樠穈菛虋鍆钔門閅门
jia3	仮佼侥假剿叚嘏夏婽岬徦徼挢捁搅撟撹攪敫斚斝椵榎槚檞檟湫狡玾甲瘕皎矫矯絞繳绞缴胛脚角賈贾踋鉀鉸钾铰餃饺
jia4	仮价価假價嫁架榢稼賈駕驾
yang3	仰养卬岟慃懩抰攁氧氱炴痒癢羏羪蝆鞅養餋駚
pi3	仳劈匹吡否噽嚭圮崥庀擗疋痞癖脴苉諀
jian4	件侟俴健僭剑剣剱劍劎劒劔建徤擶旔栫楗榗槛檻毽洊涧渐溅漸澗濺瀳牮珔监監瞷磵礀箭糋糮繝繿腱臶舰艦荐蔪薦螹襉見覵覸见諌諓諫譖譼谏谮賎賤贱趝践踐踺釰釼鉴鋻鍳鍵鏩鐗鐧鑑鑒鑬鑳锏键間间餞饯鰎
jie5	价家
yao3	仸偠咬夭婹嫍宎岆崾抭杳枖榚殀溔眑窅窈窔舀苭蓔闄騕鷕
fen4	份偾僨分坋奋奮忿愤憤橨瀵秎粪糞羵膹魵鱝鲼
di1	仾低啇嘀埞堤墑奃彽提氐滴眡磾羝袛趆鍉鏑镝鞮
fang3	仿倣彷旊昉昘瓬眆紡纺舫訪访髣鶭
pei4	伂佩姵帔斾旆沛浿珮翇苝轡辔配霈馷
diao4	伄吊弔掉瘹窎窵竨蓧訋誂調调釣銚銱鋽鑃钓铞铫魡
dun4	伅噸囤坉崸庉扽楯沌潡炖燉盾砘腞踲逇遁遯鈍钝頓顿鶨
wen4	伆免問妏抆揾搵文汶渂熓璺紊紋纹聞莬问
xin3	伈
ji4	伎偈兾冀刉剂剤劑哜嚌坖垍塈墍妓季寂寄彐彑忌悸惎懻技斉斊旡既旣暨曁梞檕檝檵洎济済漈濟瀱璾痵瘈癠皍瞡矂祭禝稩稷穄穊穧系紀継繋繫繼纪继绩罽臮芰荠萕葪蓟蔇薊薺蘎蘮蘻裚褀覬觊計記誋计记跽躋迹际際霁霽騎驥骥髻鬾魝鮆鯚鯽鰂鰶鱀鱭鲚鲫鵋齌齐
fa1	伐发彂橃発發瞂酦醗醱颰
xiu1	休俢修咻庥樇潃烌羞脩臹茠蓚蓨貅銝鎀鏅饈馐髤髹鵂鸺
bei1	伓俾偝卑埤庳悲揹杯桮椑盃碑禆綼背萆裨錃陂鵯鹎
chen2	伔塵娠宸尘屒忱愖敐晨曟樄橙沈沉煁臣茞莀莐蔯薼螴訦諶谌軙辰迧鈂陈陳霃鷐麎
fu1	伕呋夫妋姇孵尃怤敷旉柎泭玞璷砆稃筟箙箻粰糐紨綒罦肤膚荴衭豧趺跗邞鄜鈇鳺麩麬麱麸
tang3	伖伥倘偒傥儻帑戃敞曭淌爣矘耥躺鎲钂镋
you1	优優呦嚘幽忧怮悠憂懮攸櫌瀀纋耰鄾麀
huo3	伙夥漷火邩鈥钬
hui4	会僡儶匯卉哕喙嘒噦噧嚖圚嬇寭廆彗彙彚恚恵惠慧憓晦暳會桧槥橞檜櫘殨汇泋浍溃滙潓潰澮濊烩燴獩璯瞺禬秽穢篲絵繐繢繪绘缋翙翽芔荟蔧蕙薈蟪襘詯詴誨諱譓譿讳诲賄贿鏸鐬闠阓靧韢頮颒餯饖
kuai4	会侩儈凷哙噲块塊墤快會檜欳浍澮狯獪筷脍膾郐鄶駃鬠鱠鲙
cui4	伜倅啐啛忰悴橇毳淬濢焠焫琗疩瘁竁粋粹紣綷翠脃脆脺膬膵臎萃顇
zu2	伜傶卆卒哫嗾崒崪捽族足踤踿蹵鎐鏃镞
chuan2	传傳暷椽歂牀篅舡舩船諯輲遄
zhuan4	传傳僎啭囀堟撰沌灷瑑篆籑縳腞蒃襈譔賺贃赚転轉转饌馔
che1	伡俥唓砗硨莗蛼車车
ya2	伢厓堐岈崕崖押枒涯漄牙犽猚玡琊睚笌芽蚜衙谺齖
xian4	伣俔僩僴县咞哯垷姭娊娨宪岘峴憲撊晛橌涀瀗献獻现現県睍粯絤綫線縣线缐羡羨腺臔臽苋莧蜆見见誢豏轞鋧錎限陥陷霰餡馅麲
shang1	伤傷商墒慯殇殤汤湯滳漡熵蔏螪觞觴謪鬺
chang1	伥倀倡娼昌晿淐猖琩菖裮錩锠閶阊鯧鲳鼚
chen5	伧
xun4	伨侚噀巺巽徇殉殾汛浚熏爋蕈訊訓訙训讯賐迅迿逊遜鑂韗顨馴驯鵔鵕
xin4	伩信卂囟妡孞焮煡脪膷舋芯衅訫軐釁阠顖馸
zhu4	伫佇住助坾嵀杼柱柷樦櫡殶注炷疰祝秼竚筑筯箸築紵紸纻羜翥芧苎苧莇著蛀註諔貯贮跓軴鉒鋳鑄铸飳馵駐驻麆
chi3	伬侈傂叺呎垑姼尺恀恥扡拸欼歯禠粎耻蚇袳裭褫誃豉鉹鶒齒齿
xuan2	伭妶嫙悬懸旋暶檈漩玄玹琁璇璿痃縣蜁誸還
nao2	伮努呶夒峱嶩巎巙怓憹挠撓橈猱獶獿硇繷虁蛲蟯詉譊鐃铙髐
nu3	伮努弩砮胬
bai3	伯佰兡捭摆擺柏栢百矲竡粨絔襬
ba4	伯坝垻壩弝把欛灞爸猈罢罷耙覇霸鮁鮊鲅鲌
gu1	估呱咕夃姑嫴孤家柧橭毂沽泒痼笟箍箛罛苽菇菰蓇蛄觚軱軲轂轱辜酤鈲鈷骨鮕鴣鸪
gu4	估僱凅吿告固堌崓崮故梏棝榾牿痼祻稒錮锢雇頋顧顾鯝鲴
ni3	伱你儗儞妳孴抳拟擬旎昵柅檷祢禰苨薿蚭譺隬馜
ni4	伲匿埿堄嫟嬺尿屰惄慝昵暱氼泥溺睨縌胒腻膩迡逆鷁鷊
ban4	伴办半姅怑扮拌柈湴爿瓣秚絆绊辦鉡靽
xu4	伵侐勖勗卹叙嘼垿壻婿序怴恤慉敍敘旭昫朂槒汿沀洫溆漵潊烅煦珬畜盢瞁瞲稸窢絮続緒緖續绪续聟蓄藇藚訹賉酗銊鱮
zhou4	伷僽冑呪咒咮噣宙怞昼晝甃皱皺籀籒籕粙紂縐繇纣绉胄荮葤詋軸轴酎駎驟骤
shen1	伸侁信参參叅呻妽娠屾峷扟敒柛氠深燊珅甡甧申眒砷籶籸糁糂糝紳绅莘葠薓裑訷詵诜身鉮阠駪鲹鵢
qu1	伹佉凵匤区區呿坥屈岖岨岴嶇憈抾敺曲焌瞿砠祛筁粬紶胠蛆蛐袪覰覷觑詘誳诎趋趨躯軀镼阹駆駈驅驱髷魼鰸鱋鶌麯麴麹黢
ci4	伺佽刺刾廁朿栨次絘莿蛓賜赐
beng1	伻嘣塴奟崩嵭弸祊絣綳繃绷閍
ga1	伽咖嘎嘠夹旮胳
qie2	伽癿茄
qia1	伽掐葜袷
ai3	佁哎嗳噯昹欸毐矮蔼藹诶躷霭靄馤
zheng4	佂幀怔挣掙政正症癥証諍證证诤郑鄭錚钲铮鴊
dian4	佃坫垫墊壂奠婝店惦扂敟橂殿淀澱玷琔电甸痁癜磹簟蜔鈿钿阽電靛
tian2	佃塡填恬沺湉璳甛甜田畋畑盷磌窴胋菾鈿钿闐阗鷆
han2	佄函凾含圅娢寒崡晗梒榦汗浛涵焓琀筨邗邯鋡韓韩
mai4	佅劢勱卖売眿脈脉蝐賣迈邁霡麥麦
bi3	佊俾匕吡啚夶妣屄彼朼柀比沘潷疕秕笔筆粃舭貏鄙
shao4	佋劭卲召哨娋少捎潲睄稍紹綤绍袑邵颵
ci3	佌此泚玼皉跐
zuo3	佐咗唨左撮毑繓
yang1	佒坱央姎柍殃泱眏秧紻胦鉠雵鞅鴦鸯
ti3	体挮躰軆骵體
ben4	体倴坌夯奔捹撪桳犇獖笨輽
ti1	体剔掦梯焍踢銻锑鷈鷉
zhan4	佔偡占嶘战戦戰暫栈桟棧椾湛站綻绽菚蘸虥虦覱蹔輚轏顫颤驏骣
he2	何俰劾合咊和啝姀嵑廅惒曷柇核楁毼河涸滆澕熆狢盇盉盍盒礉禾秴篕紇纥翮荷菏萂蒚蓋蚵蝎螛褐覈訸詥貈貉趷郃釛鉌閡閤闔阂阖鞨頜颌餲饸魺鶡鹖齕龁龢
he4	何佫吓咊和喝嗃嚇壑寉暍煂熇爀猲癋皬碋翯荷蠚袔褐賀贺赫隺靎靏鶴鸖鹤
bi4	佖俾咉哔嗶坒埤堛壁妼婢嫳嬖币幣幤庇庳廦弊弻弼彃必怭愊愎払拂敝斃朇枈柫柲梐楅檘比毕毖毙泌湢滗滭潷濞煏熚狴獘獙珌璧畀畢疪痹痺皕睥碧秘稗筚箄箅箆篦篳粊縪罼聛腷臂芘苾荜萆蓖蓽蔽薜蜌袐裨襒襞襣觱詖诐貱賁贔贲赑跸蹕躃躄辟避邲鄙鄨鄪鉍鎞鏎鐴铋閇閉閟闢闭陛鞸韠飶饆馝駜驆骳髀魓鮅鰏鵖鷝鷩鼊
tuo2	佗坨岮柁槖橐沱狏砣砤碢紽舵袉跎迱酡釶鉇鉈铊阤陀陁鞁飥馱駄駝駞騨驒驮驼鮀鴕鸵鼉鼍鼧
tu2	余凸図图圕圖圗塗屠峹嵞庩廜徒怢捈揬梌涂湥潳瑹瘏稌突筡腯荼莵菟蒤跿途酴鈯鍎馟駼鵚鶟鷋鷵鼵
die2	佚叠咥喋垤堞峌嶀恎惵戜挕揲昳曡楪氎牅牒瓞畳疂疉疊眣眰碟絰绖耊耋聑胅臷艓苵蜨蝶褋詄諜谍趃跌跕蹀迭镻鰈鲽
zuo4	作做凿唑坐夎岞座怍柞砟祚糳胙葄袏酢鑿阼
zuo1	作嘬
zuo2	作昨椊琢秨稓笮筰葃鈼
gou1	佝勾句枸沟溝篝緱缑芶褠鈎鉤钩鞲
ning4	佞侫宁寧拧泞濘
xuan1	佡儇吅喧塇塤壎媗嬛宣弲愃愋揎昍晅暄梋煊煖瑄睻矎禤禫翧翾萱萲蕿藼蘐蝖蠉諠諼譞谖軒轩鋗鍹鶱
ju4	佢俱倨倶具剧劇勮句埧埾壉姖寠屦屨岠巨怇怚惧愳懼拒拠据據昛榘檋歫沮洰澽炬焣犋瞿秬窭窶簴粔絇耟聚苣虡蚷詎讵貗趄足距踞躆遽邭醵鉅鋸鐻钜锯颶飓駏鮔
yong1	佣傭嗈噰墉壅庸廱慵拥擁滽澭灉牎痈癕癰臃蕯邕郺鄘鏞镛雍雝饔鱅鳙
yong4	佣傭用醟
wa3	佤咓瓦瓩邷
ka3	佧卡咔咯咳胩
huai2	佪徊怀懐懷槐櫰淮瀤耲褢褱踝
lao3	佬咾姥恅栳橑潦狫老荖轑銠铑
xiang2	佭夅庠栙珦祥絴翔詳详跭降
ge2	佮匌呄咯嗝塥愅挌搁搿擱敆敋格槅獦胳膈臵茖葛蛒蛤裓觡諽輵轕鎘镉閣閤阁隔革鞷韐韚颌骼鬲鮯鰪齃
yang2	佯劷垟婸崵徉扬揚敭旸昜暘杨楊洋炀烊煬玚珜瑒疡瘍眻禓羊蛘諹輰鍚鐊钖阦阳陽霷颺飏鰑鸉
fa3	佱法灋珐砝髮
ming2	佲冥名嫇明暝朙榠洺溟熐猽盟眀瞑茗蓂螟覭詺鄍酩銘铭鳴鸣
nai4	佴倷奈柰渿耐萘螚褦錼鼐
heng2	佷姮恆恒揘桁楻横橫珩蘅行衡誙諻鑅鴴鸻
huo2	佸咊和活秳萿鈥閄
gui3	佹匦匭厬垝姽宄庋庪恑攱晷氿癸祪簋蛫蟡觤詭诡軌轨陒鬼
quan2	佺全卷啳姾婘孉峑巏恮拳搼权権權泉洤湶灥牷犈犬瑔痊硂筌縓荃葲蜷蠸觠詮诠跧踡輇辁醛銓铨顴颧駩騡鬈鰁鳈齤
tiao1	佻庣恌挑旫祧聎鮡
tiao2	佻岧岹条條樤祒笤芀苕萔蜩調调趒迢銚鋚鎥铫鞗髫鰷鲦齠龆
jiao3	佼侥僥儌剿劋勦孂徺徼挢捁搅撟撹攪敫敽晈暞曒湫湬漅灚烄煍狡璬皎皦矫矯筊絞繳绞缴脚腳臫蟜角譑賋踋較鉸铰餃饺
xing2	侀刑坓型形洐滎濚濴烆硎胻荥行邢郉鉶銒鋞钘铏陉陘餳餹饧
kan3	侃偘冚凵坎埳塪崁惂槛檻欿歁歞砍繿莰輡轗闞阚顑
zhi2	侄値值儨坧埴執墌妷姪嬂慹懫执指摭擲擿柣桎植樴殖漐犆瓆瓡直禃秷稙絷縶聀职職膱蘵蟄蟙褁質跖踯蹠蹢躑軄釞馽鯯
gai1	侅垓姟峐晐畡祴荄該该豥賅賌赅郂陔隑
kai1	侅奒开揩鐦锎開
lai2	來俫倈唻婡崃崍庲徕徠来梾棶涞淶琜筙箂莱萊郲錸铼騋鯠鶆麳
kua3	侉垮銙
guang1	侊僙光咣垙姯桄洸灮炗炚烡珖胱茪輄銧黆
yin1	侌凐喑噾囙因垔堙姻婣峾愔慇摿歅殷氤洇洕湮溵烟瘖禋秵筃絪緸绬茵荫蒑蔭裀諲銦铟闉阥阴陰陻隂霠鞇音韽韾駰骃黫
mi3	侎哶孊弭敉沵洣渳濔灖眫米脒芈葞蔝銤靡
zhu1	侏劯朱株槠橥櫧櫫洙潴瀦猪珠硃祩絑茱藷藸蛛蝫蠩袾觰誅諸诛诸豬邾銖铢鮢鴸鼄
an1	侒厂厈厰垵媕安峖广広庵廠廣桉氨痷盦盫腤萻葊蓭誝諳谙銨鞌鞍韽鵪鹌
lu4	侓僇六剹勎勠垏塶娽峍廘彔录戮摝椂樚淕淥渌漉潞熝琭璐甪盝盠睩硉碌磟祿禄稑穋箓簏簬簶籙粶绿膔菉蓼蔍蕗虂螰觮賂赂趢路踛蹗輅轆辂辘逯醁錄録錴鏕鏴陆陸露騄騼鯥鵦鵱鷺鹭鹿麓
mou2	侔劺呣恈洠牟眸繆缪蛑謀谋鉾鍪鴾麰
er2	侕儿児兒唲栭檽洏而耏聏胹荋袻輀轜陑隭髵鮞鲕鴯鸸
dong4	侗働冻凍动動垌峒恫戙挏栋棟洞硐胨胴腖霘駧
tong3	侗姛捅桶筒筩統綂统
chi4	侙傺勅叱啻彳恜慗憏懘戠抶摰敕斥杘栻淔灻炽烾熾痓痸瘛糦翄翅翤赤趩跮鉓銐飭饎饬鷘
gong1	供公共功匑嗗塨宫宮工幊弓恭愩攻杛疘碽竍竏竓竔竕竡篢糼紅红肱蚣觥觵躬躳釭龏龔龚
gong4	供共唝摃羾貢贡
zhou1	侜俼周啁喌婤州徟洀洲淍烐珘盩矪粥舟謅譸诌诪賙赒輈輖辀週銂騆鵃鸼
xia2	侠俠冾匣呷峡峽挾搳敮斜暇柙洽炠烚狎狭狹珨瑕瘕硖硤碬磍祫笚筪縖翈舝舺蕸赮轄辖遐鎋陝霞騢魻黠
zai4	侢傤儎再在扗載载
lv3	侣侶偻僂儢吕呂婁寽屡屢履挔捋捛旅梠漊祣稆穞穭絽縷缕膂膐褛褸郘鋁铝
yao2	侥倄傜僥嗂垚堯姚媱尧尭峣崤嶢嶤徭愮揺搖摇暚柼榣殽淆烑爻猇猺珧瑤瑶窑窯窰繇肴蘨謠謡谣軺轺遙遥銚鑃铫陶顤颻飖餆餚鰩鳐鼼
zhen1	侦偵堻媜嫃寊帧帪幀搸斟栕桢椹楨榛樼浈湞溱潧獉珍珎瑊甄眞真砧碪祯禎禛箴籈胗臻蒖蒧蓁薽診貞贞轃遉酙針鉁錱鍮鍼针靕駗鱵鷏
ce4	侧側冊册厕厠墄嫧廁恻惻憡拺敇测測溭畟矠笧策筞筴箣粣茦荝萗蓛遪
zhai1	侧捚摘斋斎榸齊齋
chai2	侪儕喍柴犲祡豺
nong2	侬儂农哝噥檂欁浓濃癑禯秾穠脓膿襛農辳醲鬞齈
hou4	侯候厚后垕堠後洉矦缿豞逅郈鄇鮜鱟鲎鲘
hou2	侯喉帿猴瘊睺矦篌糇翭葔銗鍭餱骺鯸
jiong3	侰僒冏囧幜泂澃炅炯烱煚煛熲皛窘絅綗褧迥逈顈颎
cheng3	侱塣庱徎悜睈裎逞騁骋
zhen4	侲圳塦娠挋振揕敶朕枕栚桭椹眹纼蜄誫賑赈酖鎭鎮镇阵陣震鴆鸩
cuo4	侳剉剒厝挫措撮歵莝莡蓌逪銼錯锉错齰
ju2	侷匊婅局巈挶掬桔梮椈橘毩泦淗湨焗犑狊箤粷菊蘜趜跼踘蹫躹輂郹鄓鋦锔陱鞠鞫駶驧鴂鵙鵴鶪鼳
ting3	侹圢挺梃涏烶珽町甼脡艇誔鋌铤頲颋
shen4	侺愼慎抻昚椹沁涁渗滲甚瘆瘎瘮眘肾胂脤腎葚蜃鋠
nan2	侽南喃奻娚暔枏枬柟楠男畘莮萳諵难難
hao1	侾傐嚆蒿薅
bian4	便卞变変弁徧忭抃揙昪汳汴炞玣緶缏艑苄覍變辡辧辨辩辫辮辯遍釆閞鴘
pian2	便楩緶缏胼腁諚諞賆蹁駢騈骈骿
tui3	俀腿蹆骽
xi4	係匸卌咥喺夕屃屓屭忥怬恄戏戯戱戲摡椞歙汐滊潟澙熂犔磶禊稧系細綌繋繫细绤翕翖肸肹舃舄蕮虩覤謑赩郤鄎醯釳釸鎎鑴阋隙隟餼饩鬩黖齂
cu4	促卒噈梀槭殧猝瘯簇縬脨蔟趗趣趨踧蹙蹴酢醋錯鏃鼀
e2	俄吪哦囮娥峨峩涐珴皒睋磀莪蛾訛誐譌讹迗鈋鋨锇頟額额騀魤鵝鵞鹅
e4	俄偔僫卾厄呃呝咢咹噩圔垩堊堨堮屵岋崿嶭恶悪惡愕戹扼搤搹枙櫮湂琧砐砨硆腭苊萼蕚蘁蚅蝁覨詻諤讍谔豟貖軛軶轭遌遏鄂鍔鑩锷閼阏阨阸頞顎颚餓餩饿鰐鱷鳄鶃鶚鹗齶
xu2	俆徐蒣
kuang3	俇儣夼
ku4	俈喾嚳库庫瘔秙絝绔袴裤褲趶酷
jun4	俊儁呁埈寯峻懏捃捘攈攟晙浚濬焌珺畯竣箘箟菌葰蔨蕈郡陖隽雋餕馂駿骏鵘
zun4	俊鱒
juan4	俊倦儁劵勌卷圈圏奆巻帣悁慻桊淃狷獧瓹眷睊睠絹绢罥羂腃鄄隽雋韏飬鬳
lang2	俍勆嫏廊桹榔欴狼琅瑯稂筤艆莨蓈蓢蜋螂躴郎郒郞鋃锒閬阆
zu3	俎爼珇祖組组詛诅阻靻
qiao4	俏僺壳峭帩撬撽殻殼窍竅翘翹誚譙诮谯躈陗鞘韒髚
yong3	俑勇勈咏埇塎壅彮恿悀惥愑愹慂搈擁柡栐永泳涌湧甬禜蛹詠踊踴銢鯒鲬
hun4	俒倱圂慁混渾溷焝諢诨
jing4	俓倞净凈凊劤劲勁境妌婙婧弪弳径徑擏敬曔桱梷浄淨濪瀞獍痉痙竞竟竧竫競竸経經经胫脛葝誩迳逕鏡镜靓靖静靚靜
san4	俕散閐
pai3	俖排矲迫
su2	俗
xi1	俙傒僁僖兮凞卥厀吸唏唽嘻噏嚱夕奚娭媐嬆嬉屖嵠巂巇希徆徯忚怷怸恓息悉悕惁惜扱扸捿攜昔晞晰晳曦析栖桸棲榽樨橀欷歖歙氥汐浠淅渓溪漆潝烯焈煕熄熈熙熹熺熻燨爔牺犀犠犧琋瓗畦疧瘄皙盻睎瞦矽硒磎礂稀穸窸粞縘繥羲翕腊膝臈臘舾茜莃菥蒵蜥螅螆螇螝蟋蠵裼西覀觹觽觿譆谿豀豨豯貕赥蹊郋郗酅醯釐錫鏭锡闟隵饻騱驨鵗黊鼷
li3	俚兣哩娌峛峢悝李欚浬澧理礼禮粴蟸蠡裏裡豊逦邐醴里鋰锂鯉鱧鲤鳢
bao3	保堡堢媬宝宲寚寳寶怉珤緥葆褓賲靌飽饱駂鳵鴇鸨
ti4	俤俶倜剃嚏嚔屉屜悌悐惕惖揥替歒殢涕籊綈绨薙裼褅迏逖逷銻鐟髢髰鬀鬄鵜
lia3	俩倆
jian3	俭倹儉减剪囝堿寋弿戩戬拣挸捡揀撿暕枧柬梘检検檢減湕瀽瑐睑瞼硷碱礆笕筧简簡絸繭翦茧藆蠒裥襇襺詃謇謭譾谫趼蹇鐗鐧锏鰔鹸鹻鹼
xiao4	俲傚効咲哮啸嘨嘯孝恔效敩斆校歗滧熽笑肖薢誟踍酵鞩
pai2	俳徘排棑牌篺簰簲輫
biao4	俵摽鰾鳔
biao3	俵婊檦表裱褾諘錶
fei4	俷剕厞吠屝废廃廢怫昲曊杮櫠沸濷狒疿痱癈砩肺胇芾蟦費费鐨镄靅鼣
feng4	俸凤奉湗焨煈縫缝葑諷賵赗鳯鳳鴌
an3	俺唵埯堷揞晻罯銨铵隌
bei4	俻倍偹備僃哱备奰孛悖惫愂憊昁梖焙牬犕狈狽珼琲碚竡糒紴背臂蓓被褙誖貝贝軰輩辈邶郥鄁鋇鐾钡鞁鞴韛
xin1	俽兟噷妡廞心忄忻惞新昕欣歆炘炛盺芯莘薪訢辛鈊鋅鑫锌馨
chi2	俿匙坻墀岻弛徥徲忯持栘歭池汦竾筂箈箎篪耛茌荎蚔蚳謘貾赿趍踟迟遅遟遲馳驰
zan2	倃偺咱
wan3	倇啘埦娩婉宛惋挽晚晩晼梚椀浣涴琬畹皖盌盶睌睕碗綩綰绾脕脘莞菀萖葂蜿輓鋄鋔錽鞔
zong3	倊偬傯忩总惣愡憁捴揔搃摠朡総緫縂總蓗
ge5	個
guan1	倌关冠唍官棺瘝癏矜綸纶莞蒄覌観觀观関闗關鰥鱞鳏
tian1	倎兲天婖屇沗添酟靝黇
dao3	倒壔导導岛島嶋嶌嶹捣搗擣祷禂禱蹈隝隯
dao4	倒到噵導帱幬悼檤焘燾瓙盗盜稲稻纛翿菿衜衟軇道
tan2	倓坛墰墵壇壜婒弹弾彈憛昙曇榃橝檀潭澹痰罈罎藫覃談譚谈谭貚郯醈醰錟鐔锬镡餤騨驔鷤黮
jue4	倔憠
chui2	倕圌垂埀娷捶搥棰椎槌湷甀箠腄菙錘鎚锤陲顀
xing4	倖兴姓婞嬹幸性悻懬杏涬緈臖興荇莕行踁
peng2	倗傰埄堋塜塳彭憉挷搒朋棚椖樥淜澎痭硼稝竼篷纄膨芃蓬蟚蟛輣錋鑝韸韼驡髼鬅鬔鵬鹏
gan4	倝凎嵅干幹旰榦檊汵涻淦灨簳紺绀芉詌贛赣骭
xu1	倠吁呴嘘噓圩墟媭嬃嬬幁戌揟旴晇楈欨欰歔殈湏疞盱砉稰籲縃繻胥蕦虗虚虛蝑訏譃鑐需須頊须顼驉鬚魆魖
chang4	倡唱怅悵暢焻玚畅畼誯韔鬯
jie2	倢偈偼傑刦刧刼劫劼卩卪喼婕孑岊崨嵑嵥巀截拮捷揤搩擳昅杰桀桔楬楶榤櫛櫭洁洯滐潔瀄犵睫碣竭節結絜緁緳结羯脻节莭蓵蜐蠘蠞蠽衱袺訐詰誱讦诘趌踕迼鉣鍻鐑頡颉騔鮚鲒
kong1	倥埪崆悾涳硿空箜錓鵼
kong3	倥孔恐
zong1	倧堫宗嵏嵕嵸怱惾枞棕椶樅熧猣磫稯綜緃緵縱综翪腙艐葼蝬豵踨踪蹤騌騣骔鬃鬉鬷鯮鯼
qian4	倩傔刋嗛堑塹壍嵌悓慊棈椠槧欠歉皘篏篟綪縴纤芡茜蒨蔳輤
ni2	倪呢坭埿婗尼屔怩泥淣狋狔猊秜籾臡蜺觬貎跜輗郳鈮鉨铌霓鯓鯢鲵鶂麑齯
zhuo2	倬剢劅卓啄啅圴彴拙撯擆擢斀斫斮斱斲斵梲棳椓槕汋泎浊浞濁濯灂灼炪烵焯琢琸着硺禚篧籱繳缴罬茁著蝃蠗諑謶诼酌鋜錣鐯鐲镯鷟
wo1	倭唩喔挝撾涡涹渦猧窝窩莴萵蜗蝸踒
luo3	倮曪瘰癳臝蓏蠃裸躶鎯
song1	倯凇娀崧嵩庺忪憽松枀枩柗梥檧淞濍硹菘蜙鬆
leng2	倰塄崚棱楞稜蔆薐
zi4	倳剚字孳恣扻洓渍漬牸眥眦胔胾自茡
cai3	倸婇寀彩採棌睬綵跴踩采
zhai4	债債寨瘵砦祭責
ye1	倻噎掖椰耶蠮
sha4	倽厦唼喢嗄帹廈歃沙煞箑翣萐閯霎
qing1	倾傾卿啨圊寈氢氫淸清狅蜻軽輕轻郬錆锖靑青頃鯖鲭
ying1	偀嘤嚶婴嫈嬰孆孾应応應撄攖朠桜楧樱櫻渶煐珱瑛璎瓔甇甖碤礯纓缨罂罃罌膺英莺蘡蝧蠳褮譻鍈鑍锳霒霙韺鴬鶧鶯鷪鷹鸎鸚鹦鹰
cheng1	偁噌埥崝憆摚撐撑柽棦橕檉泟浾牚牜琤瞠秤称稱穪竀緽蛏蟶赪赬鏿鐺铛阷靗頙頳饓
cheng4	偁牚秤称稱穪
nuan4	偄
chun3	偆惷睶萶蠢踳
ruo4	偌叒弱楉爇箬篛若蒻鄀鰙鰯鶸
ti2	偍厗啼嗁堤媂媞崹惿提漽珶瑅睼碮禔禵稊綈緹绨缇罤苐荑蕛蝭趧蹄蹏遆醍鍗隄題题騠鮷鯷鳀鴺鵜鶗鶙鹈
wei1	偎危喴委威媁媙崴巍微愄揋椳楲渨溦溾烓煨煹燰碨萎葨葳薇蝛覣逶隇隈鰃鰄鳂
pian1	偏囨媥扁片犏篇翩萹貵頨鶣
yan4	偐傿厌厭咽唁喭噞嚈嚥堰墕墱妟姲婩嬊嬿宴彥彦懨敥晏暥曣椻沿淹滟灎灔灧灩焔焰焱焸燄燕爓爗牪研砚硯艳艶艷莚覎觃觾諺讌讞谚谳豓豔贋贗赝酽醶醼釅閆隁雁餍饜騐験騴驗驠验鳫鴈鴳鷃鷰
wo4	偓卧哦幄捾握斡楃沃渥濣硪礒肟臥齷龌
xie2	偕劦勰协協叶垥奊恊愶慀拹挟挾搚携撷擕擷攜斜旪熁燲瑎籺絜綊纈缬翓胁脅脇脋脥膎葉蝢衺襭諧谐邪鞋鞵頡颉鮭鲑龤
jie1	偕啑喈嗟堦幯接掲揭擑椄楷湝疖癤皆秸稭節結结腉节菨蝔街阶階鶛
che3	偖奲尺扯撦
sheng3	偗省眚箵
di4	偙僀哋啲地坔埊墆娣嵽嶳帝弟怟慸摕旳杕梊棣楴樀渧焍爈玓珶甋的睇碲祶禘第綈締绨缔肑腣菂蒂蔕虳螮諦谛踶軑递逓遞釱鉪馰
cha1	偛叉喳嗏嚓嫅差扠扨挿插揷杈疀碴肞艖銟鍤鎈锸餷馇
huang2	偟凰喤堭墴媓崲徨惶撗湟潢煌熿獚瑝璜癀皇磺穔篁簧艎葟蝗蟥趪遑鍠鐄锽隍韹餭騜鰉鱑鳇鷬黃黄
yan1	偣剦厭咽啱奄嫣嬮崦恹懕懨殷淹湮漹烟焉煙燕猒珚篶胭腌臙菸鄢酀醃閹閼阉阏
you2	偤尢尣尤峳怣斿柚楢櫾沋油浟游滺犹猶猷由疣秞繇肬莜莤莸蕕蚰蝣蝤訧輏輶逌逰遊邎邮郵鈾铀駀魷鮋鱿鲉
xu3	偦冔喣姁栩浒湑滸煦珝盨糈許詡諝许诩谞鄦醑
zha1	偧吒咋哳喳宱扎抯挓揸摣柤查査楂樝渣皶皻茬謯齄齇
chai1	偨差拆芆釵钗
bi1	偪屄毴皀稫螕豍逼鲾
xun2	偱噚寻尋峋巡廵徇循恂旬杊枔栒桪槆橁毥洵浔潯燖珣璕畃紃荀荨蕁蟳詢询郇馴駨鱏鱘鲟
cai1	偲猜
duan1	偳剬媏端耑褍
ou3	偶吘呕嘔耦腢蕅藕
tou1	偷偸婾媮
za2	偺咱囐嶻杂砸磼襍雑雜雥韴魳
lou2	偻僂剅喽嘍娄婁廔楼樓溇漊熡瞜耧耬艛蒌蔞蝼螻謱軁遱鞻髅髏鷜
kui3	傀峞煃跬蹞頍
sou3	傁叜叟嗾擞擻櫢瞍籔薮藪謏
su4	傃僳嗉塐塑夙嫊宿愫愬憟栜榡樕橚殐泝洬涑溯溸溹潚潥玊珟璛碿簌粛粟素縤縮缩肃肅膆蓿蔌藗蜶觫訴誎謖诉谡趚蹜速遡遫遬鋉餗驌骕鱐鷫鹔
xia1	傄呷煵疨瞎虾蝦鍜閕颬鰕
yuan4	傆噮垸夗媛怨愿掾瑗禐苑衏褑褤謜遠院願
rong3	傇冗宂搑氄茸軵
ru4	傉入嗕媷孺洳溽縟缛茹蓐褥辱鄏
yun3	傊允喗抎殒殞狁狇玧磒褞賱輑鈗阭陨隕霣
gou4	傋冓勾唦坸垢够夠姤媾彀搆撀构構簼覯觏訽詬诟購购遘雊韝
ma4	傌唛嘜帓杩榪睰祃禡罵蚂螞閁駡骂
bang4	傍塝搒旁棒棓磅稖膀艕蒡蚌蜯謗谤鎊镑
bang1	傍垹帮幇幚幫捠梆浜縍邦邫鞤
dian1	傎厧嵮巅巓巔掂攧敁槇槙滇瘨癫癲蹎顚顛颠齻
tang2	傏唐啺堂塘搪棠榶樘橖溏漟煻瑭磄禟篖糃糖糛膅膛蓎薚螗螳赯踼鄌醣鎕鏜镗闛隚餳餹饄饧鶶
shan1	傓删刪剼埏姍姗山彡扇挻搧杉杦栅椙檆潸澘烻煽狦珊穇笘縿羴羶脠膻舢芟苫衫跚軕邖釤钐髟
yong2	傛傭喁嫆嫞嵱槦顒颙
suo1	傞唆嗍嗦娑挱挲摍桫桬梭樎睃簑簔縮缩羧莎莏蓑趖鮻
wang1	傟尢尣尩尪尫汪
dai3	傣歹歺逮
bin1	傧儐宾彬斌梹椕槟檳汃滨濒濱濵濹瀕玢瑸璸矉繽缤蠙豩豳賓賔邠鑌镔霦顮馪驞
chu3	储儲処处杵椘楚楮檚濋础礎處褚齭齼
nuo2	傩儺娜挪捼梛郍
zan1	傪兂簪簮糌鐕
lei3	傫儡厽垒塁壘樏櫐櫑洡灅瘣癗磊磥礧礨累絫耒蕌蕾藟蘲蘽虆誄讄诔鑸頛鸓
cui1	催嗺墔崔摧榱槯獕磪缞衰鏙隹
zao1	傮糟蹧遭
song3	傱嵷怂悚愯慫楤竦耸聳駷
ao4	傲坳垇墺奡奥奧嫯岙嶴慠懊扷拗擙澚澳詏鏊驁骜
qiang3	傸勥墏弜強强抢搶磢繈繦羟羥襁鏹镪
qiang1	傹呛嗆将將嶈戕戗戧抢搶斨枪椌槍溬牄猐玱琷瑲矼篬羌羗羫腔蜣謒跄蹌蹡錆鎗鏘鏹鑓锖锵镪
sha3	傻儍
han4	傼哻垾屽悍憾扞捍撖撼攌旱晘晥暵汉汗涆淊漢澏瀚焊熯犾猅皔睅翰莟菡蛿蜭螒譀豻釬銲鋎閈闬雗頜頷顄颔馯駻鶾
zhang1	傽嫜张張彣彰慞暲樟漳獐璋章蔁蟑遧鄣餦騿鱆麞
qing2	傾剠勍夝情擎晴暒樈檠殑氰甠黥
piao1	僄剽勡慓旚漂縹缥翲薸螵飃飄飘魒
lian3	僆摙敛斂琏璉羷脸臉蔹蘞裣襝鄻
man4	僈墁嫚幔慢曼槾漫澫澷熳獌縵缦蔄蔓謾谩鏝镘
ying2	僌営塋媖嬴巆廮攍楹櫿溁滎滢潆濙濚瀅瀛瀠瀯熒營瑩盁盈籝籯縈茔荥荧莹萤营萦萾蓥藀蛍蝇蝿螢蠅謍贏赢迎鎣
xiang4	像勨向嚮巷恦曏橡潒相萫蚃蟓蠁襐象鐌闀闂項项鱌
shan3	僐掸掺摻撣晱睒覢閃闪陕陜陝陿
tui2	僓弚橔穨蘈蹪隤頹頺頽颓魋
zun3	僔噂墫撙譐
lao4	僗勞唠嘮嫪憦橯涝澇烙絡络耢耮落軂酪髝
chang3	僘厂厈厰场場塲廠惝敞昶氅鋹
liao2	僚嘹嫽寥寮尞屪嵺嶚嶛廫憀摎撂撩敹漻潦熮燎獠璙疗療窷簝繚缭聊膋膫豂賿蹘辽遼鐐镽顟飂飉髎鷚鷯鹩
deng4	僜凳墱嶝櫈澂澄瞪磴蹬邆邓鄧鐙镫隥霯
chan2	僝劖单単單嚵壥婵嬋孨孱巉廛棎毚湹潹潺澶瀍瀺煘獑磛禅禪緾繵纏纒缠艬蝉蟬蟾誗讒谗躔鄽酁鋋鐔鑱镡镵饞馋
fan1	僠嬏帆幡旙旛番籓繙翻蕃藩轓飜鱕
chuan3	僢喘堾舛荈
tie3	僣帖鉄鐡鐵铁驖
jiu4	僦匓匛匶厩咎媨就廄廏廐慦捄救旧柩柾桕疚究臼舅舊鯦鷲鹫麔齨
seng1	僧鬙
zhuang4	僮壮壯壵幢戆戇撞焋状狀
jiang1	僵壃姜将將摪橿殭江浆漿瓨畕畺疅疆礓繮缰翞茳葁薑螀螿豇韁鱂鳉
min3	僶冺刡勄悯愍慜憫抿敃敏敯暋泯湣潣澠皿笢簢閔閖閩闵闽鰵鳘黽黾
pi4	僻嚊媲嫓屁揊淠渒潎澼甓癖睤睥礔譬辟闢髲鷿鸊
sai4	僿嗮塞簺賽赛
shan4	儃剡单善單墠墡嬗扇掞掸摲撣擅椫汕煽疝磰禅禪繕缮膳苫蟮蟺訕謆譱讪贍赡赸鄯釤銏鐥钐饍騸骟鱓鱔鳝鳣
dang1	儅噹嵣当澢珰璫當筜簹艡蟷裆襠鐺鑁铛
bin4	儐摈擯殡殯膑臏髌髕髩鬂鬓鬢鶣
an4	儑匎匼堓婩岸按暗案洝犴胺荌菴豻貋錌闇鮟黬黯
ru2	儒嚅如孺帤挐曘桇渪濡燸筎臑茹蕠薷蠕袽襦邚醹銣铷顬颥鱬鴽
tai2	儓台坮嬯抬擡旲枱檯炱炲秮籉臺苔菭薹跆邰颱駘骀鮐鲐
lan2	儖兰厱囒婪岚嵐幱懢拦攔斓斕栏欄欗澜瀾灆灡燣燷璼礷篮籃籣糷葻蓝藍蘫蘭褴襕襤襴譋讕谰躝鑭钄镧闌阑韊
meng2	儚冡幪曚朦橗檬氋氓濛甍甿盟瞢矇矒礞艨莔萌萠蒙蕄虻蝱鄳鄸雺靀饛鯍鸏鹲
neng2	儜能薴
qiong2	儝卭嬛宆惸桏棾橩焭煢琼璚瓊睘瞏穷穹窮竆笻筇茕蒆藑藭蛩赹跫輁邛銎
lie4	儠冽列劣劽埒埓姴巤挒捩擸洌浖烈煭犣猎猟獵睙聗脟茢蛚蛶裂趔躐迾颲鬛鬣鮤鱲鴷
bao4	儤刨勽嚗報忁报抱暴曓曝瀑爆犦菢虣蚫袌豹趵鉋鑤铇鮑鲍
du2	儥凟匵嬻椟櫝殰毒涜渎瀆牍牘犊犢独獨瓄皾纛蝳読讀讟读豄贕鑟韇韥頓顿騳髑黩黷
biao1	儦勺墂幖彪摽杓标標滮瀌灬熛爂猋瘭磦穮羆脿膘臕蔈藨謤贆鏢鑣镖镳颩颮颷飆飇飈飍飑飙飚驃驫骉骠髟麃
zan3	儧儹喒噇寁拶揝撍攅攒攢昝桚沯礸禶趱趲
hao2	儫勂号嗥嘷噑嚎壕椃毫濠狢獆獋獔籇號蚝蠔諕譹豪貉鶴
chen4	儭嚫夦榇櫬疢秤称稱穪藽衬襯讖谶趁趂齔龀
teng2	儯幐滕漛疼籐籘縢腾藤螣誊謄駦騰驣鰧
long2	儱咙嚨屸嶐巃巄昽曨朧栊槞櫳泷湰滝漋瀧爖珑瓏癃眬矓砻礱礲窿竜笼篭籠聋聾胧茏蘢蠪蠬襱豅躘鏧鑨隆霳靇鸗龍龒龓龙
chu2	儲刍厨墸幮廚曯橱櫉櫥滁犓篨耡芻蒢蒭蕏蜍趎跦蹰躇躕鉏鋤锄除雏雛鶵
chan4	儳忏懴懺硟羼韂顫颤
rang2	儴勷攘瀼獽瓤禳穣穰蘘蠰躟鬤
luo2	儸剆囉椤欏猡玀箩籮罗羅脶腡萝蔂蘿螺覙覶覼逻邏鏍鑼锣镙饠騾驘骡鸁
zuan3	儹籫繤纂纉纘缵鑽
lei4	儽擂攂泪涙淚禷类累纇肋蘱酹銇錑頪類颣
nang4	儾齉
r2	儿
yuan2	元円原厡厵员員园圆圎園圓圜垣塬妧媛媴嫄尛援杬榞榬橼櫞沅湲源溒爰猨猭猿獂笎緣縁缘羱芫蒝薗蚖蝝蝯螈袁貟贠轅辕邍邧鎱騵魭鶢鶰黿鼋
xiong1	兄兇凶匈哅忷恟汹洶胷胸芎訩詾讻賯
chong1	充冲嘃徸忡憧摏沖浺涌湧珫祌翀舂艟茺衝蹖
zhao4	兆召垗旐晁曌枛棹櫂炤照燳狣瞾笊箌罩羄肁肇肈詔诏赵趙雿鵫
dui4	兊兌兑对対對怼憝憞懟敦濧濻瀩碓綐薱譈轛鐓鐜镦队陮隊
ke4	克兙兡刻剋勀勊厒可喀嗑垎娔客尅恪愙揢搕榼氪溘碦緙缂蚵課课锞騍骒
tu4	兎兔吐堍莵菟鵵
er1	兒
dang3	党挡擋攩檔欓灙譡讜谠黨
dou1	兜兠吺橷篼蔸郖都
fen1	兝分吩岎帉昐朆梤棻氛玢砏竓竕紛纷翂芬衯訜酚鈖隫雰餴饙鳻
mao2	兞堥媌嫹旄枆毛渵牦猫矛罞茅茆蝥蟊覒軞酕錨锚髦髳鶜
kuang4	兤况卝圹壙岲彉懭旷昿曂曠框況爌眖眶矿砿礦絋絖纊纩貺贶躀邝鄺鉱鑛黋
nei4	內内氝那
ba2	八叐坺墢妭抜拔炦犮秡胈茇菝詙跋軷鈸馛魃鼥
liu4	六坴塯廇溜澑熘畂碌磂翏蹓遛鎦鐂镏陆陸雡霤餾馏鬸鷚鹨
gong3	共巩廾拱拲栱汞珙礦穬蛬銾鋛鞏鞐
xing1	兴垶惺星曐煋猩瑆皨篂腥興蛵觪觲鍟馨馫騂骍鮏鯹
ci2	兹垐嬨慈柌濨珁瓷甆疵磁祠粢糍茈茨薋詞词辝辞辤辭雌飺餈鷀鹚
jian1	兼冿囏坚堅奸姦姧孯尖幵廌惤戋戔揃搛椷樫櫼歼殱殲浅淺渐湔溅漸濺瀐瀸煎熞熸牋犍猏玪监監睷碊礛笺箋篯籛緘縑缄缣肩艰艱菅菺葌蒹蕑蕳虃譼豜豣鈃鑯間间靬鞬鞯韀韉飦餰馢騝鬋魐鰜鰹鲣鳒鳽鵳鶼鹣麉
shou4	兽受售壽夀寿授涭狩獣獸痩瘦綬绶膄鏉
jiong1	冂冋坰埛扃蘏蘔駉駫
mao4	冃冐冒媢帽懋旄暓柕楙毷瑁皃眊瞀瞐耄艒芼茂萺袤貌貿贸鄚鄮
ran3	冄冉呥姌媣嫨染橪珃苒髯
mao3	冇卯夘峁戼昴泖笷茆鉚铆
mou3	冇某踇
gang1	冈冮刚剛堈堽岗岡崗扛掆杠棡犅疘碙笐綱纲缸罁罒罡肛釭鋼鎠钢
gua3	冎剐剮叧呱寡
mi4	冖冪嘧塓宓宻密峚幂幎幦榓樒櫁汨泌淧淿滵漞濗祕秘簚糸糹纟羃蔤藌蜜蠠覓覔觅謐谧鼏
yin2	冘凐吟唫噖嚚圁圻垠夤婬寅崟崯斦檐檭殥泿淫滛烎狺璌碒苂荶蔩蟫訔訚訡誾鄞釿鈝銀鏔银霪鷣齦龂龈
xie3	写冩寫藛蠏血
mi2	冞壐弥彌戂擟攠檷瀰爢猕獼瓕眯祢禰籋糜縻罙蒾蘪蘼詸謎谜迷醚醾醿釄镾靡鸍麊麋麛
zhong3	冢喠埫塚尰歱瘇种種肿腫踵
zui4	冣墬嶵晬最栬槜檇檌祽稡絊罪蕞襊辠逨酔酻醉鋷錊
yuan1	冤剈囦嬽宛寃惌棩淵渁渆渊渕灁眢箢肙葾蒬蜎蜵裫裷鋺駌鳶鴛鵷鸢鸳鹓鼘鼝
kou4	冦叩宼寇怐扣敂滱瞉窛筘簆蔲蔻釦鷇
tai4	冭太夳忲态態汰泰溙燤粏肽舦酞鈦钛
feng2	冯堸夆摓浲渢漨綘縫缝艂逢馮
ping2	冯凭凴呯坪屏屛帡帲幈平慿憑枰泙洴炾玶瓶甁甹竮箳簈缾胓艵苹荓萍蓱蘋蚲蛢評评軿輧郱馮鮃鲆
chong4	冲揰衝銃铳
leng3	冷
pan4	冸判叛拚沜泮溿炍牉畔盼袢襻詊鑻頄頖
xian3	冼姺尟崄嶮幰搟攇显櫶毨洗烍燹狝猃獫獮玁癬禒筅箲藓蘚蚬蜆赻跣銑鍌铣险険險韅顕顯鮮鲜鼸齴
mei3	凂媄媺嬍嵄挴毎每浼渼燘美鎂镁黣
zhun3	准凖埻準綧隼鶽
liang2	凉墚梁椋樑涼簗粮粱糧綡良莨踉輬辌量駺
diao1	凋刁叼奝弴彫扚殦汈琱瞗碉虭蛁貂雕鮉鯛鲷鳭鵰鼦
cou4	凑楱湊腠輳辏
ai2	凒呆啀娾崖嵦挨捱敱敳癌皑皚睚騃
ming3	凕姳慏眳酩
cui2	凗慛皠翆
duo2	凙剫夺奪度敓敚敠敪椯毲痥腏莌襗踱鈬鐸铎鮵
ning2	凝咛嚀嬣宁寍寕寗寜寧拧擰柠檸狞獰甯聍聹苎苧鑏鬡鸋
fan2	凡凢凣勫匥墦帆忛憣杋柉棥樊橎泛瀪瀿烦煩燔璠矾礬笲籵緐繁羳膰舧蕃薠藩蘩蠜襎蹯釩鐇钒颿鷭
kai3	凯凱剀剴嘅垲塏恺愷慨暟楷蒈豈輆鍇鎧铠锴闓闿颽
tu1	凸堗宊嶀捸涋痜禿秃突葖鋵鵚
gu3	凸古唂唃嘏尳愲扢杚榖毂汩淈滑濲瀔牯牱狜皷皼盬瞽穀糓縎罟羖股脵臌薣蛄蛊蛌蠱詁诂谷賈贾轂鈷钴餶馉骨鵠鶻鹄鹘鼓鼔
ao1	凹柪梎熬軪
wa1	凹劸呱哇坬娲媧屲挖搲攨洼溛漥畖穵窪聉蛙鼃
chu1	出初岀樗貙齣
dang4	凼圵垱壋宕当愓挡擋档氹璗瓽當盪瞊砀碭礑簜荡菪蕩蘯趤逿闣雼
zao2	凿醩鑿
dao1	刀刂叨幍忉朷氘舠釖魛鱽
chuang1	刅创創囪憃戧摐疮瘡窗窻
qie4	切匧契妾怯悏惬愜慊挈朅洯淁砌穕窃竊笡箧篋藒蛪趄踥郄鍥锲鯜
qie1	切
kan1	刊勘堪嵁戡栞看龕龛
cun3	刌忖
wen3	刎吻呡桽稳穏穩紊肳脗
hua4	划劃化华婳嫿嬅崋摦杹桦槬樺澅画畫畵繣舙華蕐觟話諣譮话
hua2	划劃华哗嘩崋樺滑猾磆華蕐螖譁豁釫鏵铧驊骅
huai5	划
liu2	刘劉嚠媹嬼嵧懰旈旒榴橊沠流浏瀏琉瑠瑬璢畄留畱疁瘤癅硫蒥蓅藰裗遛鎏鎦鏐鐂镏镠飀飅飗餾馏駠駵騮驑骝鰡鶹鷎鹠麍
ze2	则則咋啧嘖崱帻幘択择擇沢泽澤皟瞔窄笮箦簀耫舴萴蔶蠈蠌諎謮責賊賾责赜迮齚
chuang4	创刱剙創怆愴獊闖
qu4	刞厺去娶漆耝覰覷覻觑趣閴闃阒麮鼁
bie2	別别咇徶莂蟞襒蹩
pao2	刨匏咆垉庖炮炰爮狍瓟袍跑軳鞄麅
bie4	别彆縪
gua1	刮劀呱懖括栝煱瓜瘑筈緺聒胍腡膼葀蝸趏踻銽頢颳騧鴰鸹
gen1	刯根跟
ku1	刳哭圐堀扝枯桍橭矻窟胐跍郀顝骷
duo4	刴剁咄垛垜堕墮墯尮嶞度惰憜柁柮桗沲炧炨舵貀跥跺陊陏飿饳馱駄驮鵽
shua1	刷唰鮛
shua4	刷誜
quan4	券劝勧勸烇牶絭
xuan4	券埍怰旋昡楥楦泫渲炫眩眴碹絢縼繏绚蔙衒袨讂贙鉉鏇铉镟鞙颴駽
ci1	刺呲差庛疵赼趀雌骴
ke1	刻呵嗑坷峇嵙柯棵樖牁犐珂疴瞌砢磕礚科稞窠簻胢苛萪薖蝌軻轲醘鈳钶頦顆颏颗髁
gui4	刽刿劊劌嶡巜攰昋暩柜桂桧楿檜櫃溎炅炔筀蓕貴贵跪鞼鱖鱥鳜
xue1	削吙嶨薛辥靴鞾
xiao1	削呺哓哮啋嘋嘐嘵嚣嚻囂婋宯宵庨彇憢撨枭枵梟櫹歊毊消涍潇潚瀟灱灲烋焇獢痚痟硝硣穘窙箫簘簫綃绡肖膮萧萷蕭藃虈虓蛸蟏蟰蠨踃逍銷销霄驍骁髇魈鴞鸮
xue4	削坹岤桖泬穴血袕謔謞谑趐雪
la4	剌拉揧攋楋溂瓎瘌腊臈臘落蜡蝋蝲蠟辢辣鑞镴鬎鯻鵣
la2	剌喇拉揦旯砬磖
pou1	剖吥
pou3	剖咅哣婄廍掊棓犃
po3	剖叵尀笸鉕钷頗
wan1	剜塆帵弯彎湾潫灣莞蜿豌
bo1	剝剥岥嶓拨撥播柭波玻癶盋砵碆缽般菠蕃袚襏趵蹳鉢钵餑饽驋髉鱍
duo1	剟咄哆嚉多夛崜掇柁茤裰
bao1	剥勹包孢枹炮煲笣胞苞蕔褒襃齙龅
huo4	剨咊和咟嗀嚄嚯嚿壑奯彟彠惑或捇掝擭旤曤楇檴沎湱濩瀖獲瓁癨眓矆矐矱硅礊祸禍穫耯臒艧获蒦藿蠖謋讗豁貨货鑊锪镬雘霍靃韄騞鱯
zha2	剳劄喋扎札炸甴箚紥紮蚻蠿譗軋轧鍘铡閘闸霅
juan1	剶勬圈圏姢娟捐朘涓脧蠲裐身鎸鐫镌鵑鹃
tuan2	剸团団團慱抟摶槫漙糰鏄鷻
fou2	剻哹紑罘芣裦
piao4	剽嘌彯徱漂票篻蔈顠驃骠
kou1	剾彄抠摳眍瞘芤袧鏂
chao1	剿勦吵巐弨怊抄欩焯绰罺訬超鈔钞
qiao1	劁勪塙墝墽嵪幧悄敲橇硗磽繑繰缲趬跷蹺蹻郻鄡鍫鍬鏒鐰锹雀頝骹髜
tang1	劏嘡坣汤湯羰耥蝪趟蹚鏜鐋铴镗鞺鼞
huo1	劐嚄攉耠豁鍃鍯鏓锪
cuan2	劗巑攅攒攢櫕
mo2	劘嚤嚩嚰嫫摩摸摹擵无模橅無磨糢膜藦蘑謨谟饃饝馍髍魔麽
zhu2	劚朮术灟炢烛燭爥瘃窋竹竺笁笜筑築篫舳茿蓫蠋蠾術趉躅軸逐鱁
keng1	劥吭坈坑妔娙挳摼牼硁硜硻銵鍞鏗铿阬
zhi3	劧厎只咫址坁夂帋徵恉扺抧指旨晊枳栺止沚洔淽疻砋祇祉紙纸芷藢襧訨趾軹轵酯阯黹
qu2	劬匷忂懅戵斪朐欋氍淭渠灈玃璖璩癯瞿磲籧翑翵胊臞菃葋蕖蘧螶蟝蠷蠼衢豦貜躣軥鑺鴝鸜鸲麴鼩
lao2	劳労勞哰唠嘮崂嶗憥浶澇牢痨癆磱窂簩蟧醦醪鐒铹
kou3	劶口
kuang1	劻匡匩哐恇框洭硄筐筺誆诓軭邼
xun1	勋勛勲勳坃埙塤壦曛焄焅熏燻獯矄窨纁臐荤葷蔒薫薰蘍醺
meng3	勐懜懞懵猛獴瓾艋蒙蜢蠓錳锰鯭
lai4	勑娕櫴濑瀨瀬癞癩睐睞籁籟藾賚賴赉赖頼顂
lei1	勒擂
kai4	勓咳壒忾愒愾慨欬炌炏烗
kan4	勘墈嵌看瞰矙磡竷衎闞阚鬫
weng3	勜塕暡浻瞈聬蓊
sheng1	勝升呏声斘昇曻殅泩湦焺牲狌狕珄生甥竍竏竓竔竕竡笙聲胜苼鉎阩陞鵿鼪
qin2	勤厪嗪噙嫀庈廑懃懄捦擒斳檎溱澿珡琴琹矜禽秦耹肣芩芹菦螓蠄覃赺鈙雂靲鵭
lv4	勴卛嵂律慮氯滤濾爉率綠緑绿膟菉葎葏虑鑢
che4	勶坼屮彻徹掣撤澈烲爡瞮硩聅轍迠
shao2	勺圴杓牊玿竰芍苕韶
shuo4	勺妁帥揱搠数數朔槊欶烁爍獡率矟硕碩箾蒴蟀鎙鑠铄
peng1	匉嘭怦恲抨梈漰澎烹砰硑磞軯閛駍
tao2	匋咷啕桃梼檮洮淘濤燾祹綯绹萄裪迯逃醄鋾錭陶鞀鞉饀駣騊鼗
da2	匒呾妲怛打沓炟畗畣瘩笪答繨荅荙薘蟽詚达逹達鐽闒阘靼鞑韃
qiong1	匔焪穹
hua1	化华哗嘩砉花芲華蕐錵鷨
bei3	北鉳
nao3	匘垴堖恼悩惱瑙碯脑脳腦
shi5	匙殖
fang1	匚坊妨方枋汸淓牥芳蚄邡鈁钫鴋
za1	匝咂帀扎抸拶沞紮臜臢迊鉔
jiang4	匞匠将將嵹弶強强彊摾洚浆漿犟糡糨絳绛虹袶謽酱醤醬降
cang2	匨蔵藏鑶
zang4	匨塟奘弉脏臓臟葬蔵藏銺
fei3	匪奜悱斐朏棐榧猆篚翡菲蕜蜚誹诽餥
kui4	匮匱喟嘳媿尯愦愧憒撌椢槶樻溃潰瞆瞶硊篑簀簣籄聩聭聵蒉蔮蕢鐀鑎餽饋馈騩
suan3	匴
ou1	区區嘔塸慪櫙欧歐殴毆沤漚熰瓯甌蓲謳讴鴎鷗鸥
bian3	匾惼扁碥窆糄萹藊褊貶贬
nian4	卄唸埝廿念淰艌酿鼰齞
sa4	卅攃櫒脎萨薩钑隡颯飒馺
na1	南那
shuai4	卛咰帅帥率繂蟀
bu3	卜卟哺埔堡捕獛蔔补補鳪
bo5	卜啵膊蔔
zhan1	占呫噡嶦旃旜栴毡氈氊沾瞻粘薝覘詀詹譠譫讝谵趈邅鉆霑饘驙鱣鸇鹯
qia3	卡跒酠
lu2	卢嚧圥垆壚庐廬攎曥枦栌櫨泸瀘炉爐獹玈瓐盧矑籚纑罏胪臚舮舻艫芦蘆蠦轤轳鈩鑪顱颅髗魲鱸鲈鸕鸬黸
lu3	卤塷掳擄樐橹櫓氇氌滷澛瀂硵磠艣艪芦蓾蘆虏虜鏀鐪鑥镥魯鲁鹵
gua4	卦啩挂掛絓罣罫褂詿诖髺
ang2	卬岇昂昻
yin4	印垽廕慭憖憗懚朄檼湚濥猌癊窨胤茚荫蔭酳隱飮飲饮鮣
que4	却卻埆墧崅怯恪悫愨慤搉榷殼毃灍燩皵硞确碏確碻礐礭趞闋闕阕阙雀魥鵲鹊
luan3	卵
juan3	卷埢巻捲臇菤錈锩
han3	厂厃喊嚂浫罕蔊豃闞阚
ting1	厅厛听庁廰廳桯汀烃烴耓聴聼聽艼鞓
zhe2	厇哲啠喆嚞埑悊慴懾折摘摺晢杔歽瓋砓磔籷耴虴蛰蜇蟄褶襵詟謫謺讁讋讘谪輒輙轍辄辙銸鮿鸅
she4	厍厙射弽慑懾拾捑捨摂摄攝欇歙涉渉滠灄社舍舎葉蔎蠂設设赦韘騇麝
zha3	厏拃渣眨砟苲踷鮓鲊鲝
pang2	厐厖嫎尨庞庬彷徬旁磅篣膀舽蒡螃逄雱霶騯鰟鳑龎龐
si5	厕厠
zui1	厜堆嶉朘樶纗
ao2	厫嗷嗸嚣囂嶅廒摮敖滶熬爊獒獓璈磝翱翺聱蔜螯謷謸遨鏖隞鰲鳌鷔鼇
du1	厾嘟督都醏闍阇
can1	参參叅湌蓡薓謲飡餐驂骖
cen1	参參叅嵾梫薓
cha2	叉垞察嵖搽查査楂槎檫猹碴秅臿茬茶詧鍤
cha3	叉衩蹅鑔镲
shuang1	双孀孇欆泷滝瀧礵艭雙霜驦骦鷞鸘鹴
fan3	反返魬
shou1	収收荍
guai4	叏夬廥怪恠旝癐
fa4	发珐琺蕟髪髮
shu2	叔埱塾孰掓淑焂熟璹秫菽虪襡贖赎跾鸀
zhui4	叕坠墜惴硾礈窡笍綴縋缀缒膇譵贅赘錺鑆餟
qu3	取娶曲浀竬筁紶苣詓麯齲龋
rui4	叡壡枘汭瑞睿芮蚋蜹銳鋭锐
tao1	叨夲嫍幍弢慆掏搯槄涛滔濤焘燾瑫絛縚縧绦翢蜪詜謟轁鞱韜韬飸饕
dao2	叨捯
jiao4	叫呌嘂嘦噍噭嚼峤嶠徼挍敎教斠校滘漖潐爝珓皭窌窖藠覐覚覺觉訆譥較轎轿较酵醮釂
zhao1	召啁嘲妱巶招摷昭晁朝柖盄着著釗鉊鍣钊駋
ke3	可坷堁岢嶱敤渇渴炣礍軻轲閜鲄
tai1	台囼坮孡胎臺苔
hao4	号哠好峼悎昊昦晧暤暭曍浩涸淏滈澔瀥灏灝皓皜皞皡皥秏耗聕薃號鄗鎬镐顥颢鰝
tan4	叹嘆埮探歎湠炭碳
hong1	叿吽呍哄哅揈渹烘焢硡薨訇谾軣輷轟轰鍧閧顭魟
yu1	吁峿扜於毺淤瘀盓穻箊籲紆纡虶迂迃
mang2	吂哤奀娏尨忙恾悂杗杧氓浝牤牻狵痝盲盳硭笀芒茫蘉蛖邙釯鋩铓駹鼆
chi1	吃哧喫嗤噄妛媸彨彲摛瓻痴癡眵瞝笞絺蚩螭訵誺貾魑鴟鵄鸱麶黐齝齹
cun4	吋寸籿銌
tong4	同恸慟憅痛蘳衕通
tu3	吐唋土圡釷钍
a1	吖呵啊腌錒锕阿
ma3	吗嗎嘜溤犸獁玛瑪码碼蚂螞鎷馬马鰢鷌
ma2	吗嘛犘痲蔴蟆蟇麻麼
lin4	吝恡悋橉淋焛膦蔺藺賃赁躏躙躪閵
tun1	吞呑啍噋旽暾朜涒
qin4	吢吣唚抋揿搇撳沁菣
ba5	吧杷琶罢罷
dun1	吨噸墩墪惇撉撴敦犜礅蜳蹲蹾鐓镦驐
hang2	吭斻杭桁珩筕絎绗航苀蚢行貥迒雽頏颃魧
shun3	吮揗楯盾賰
chao3	吵炒煼眧麨
na4	吶呐呢妠娜抐捺笝納纳肭蒳衲袦訥豽軜那鈉钠魶
chuo4	吷啜嚽娖婥婼惙擉歠涰珿畷磭綽繛绰腏諁趠輟辍辵辶逴酫醊鑡齪齱龊
chui1	吹炊龡
chui4	吹炊諈
hou3	吼犼
ou2	吽
gao4	吿告煰祮祰禞膏誥诰郜鋯锆鯌
ya5	呀
e5	呃
mei2	呅堳塺媒嵋徾攗枚栂梅楣楳槑沒没湄湈煤猸玫珻瑂眉睂禖篃糜脄脢腜苺莓葿郿酶鋂鎇镅霉鶥鹛黴
dai1	呆呔待懛獃
na5	呐哪
ne4	呐呢訥讷
ne5	呐呢
m2	呒嘸
tai3	呔
ou4	呕嘔怄慪沤漚
bei5	呗唄臂
bai4	呗唄庍拜拝敗矲稗粺薭蛽贁败
yun4	员員囩均夽孕恽惲愠慍晕暈枟熨緷缊腪蕴薀藴蘊貟贠运運郓鄆酝醖醞韞韫韵韻鶤
guo1	呙咼啯嘓埚堝墎崞涡渦濄聒蝈蟈过過郭鈛鍋锅
qiang4	呛唴嗆戗戧炝熗羻跄蹌
shi1	呞嘘噓失尸屍师師施浉湤湿溮溼濕狮獅箷絁葹蒒蓍虱蝨螄褷襹詩识诗邿酾釃鈟鯴鰤鲺鳲鳾鶳鸤
quan3	呟圈汱犬犭琄甽畎綣绻虇
pen3	呠翉翸
di3	呧坘坻底弤抵拞掋柢氐牴砥聜茋菧觝詆诋軧邸阺骶
he1	呵哬喝嗬峆抲訶诃
a2	呵啊嗄阿
a3	呵啊
a4	呵啊阿
a5	呵啊阿
pei1	呸坏垺妚娝岯柸肧胚衃醅
ming4	命暝
zui3	咀嘴噿嶊洅濢璻觜
huo5	咊和
za3	咋鮺
hai1	和咍咳嗨嘿
he5	和
hu2	和喖嘝囫壶壷壺媩弧抇搰斛核楜槲湖瀫焀煳狐猢猤瑚瓳箶糊絗縠胡葫蔛蝴螜衚觳醐鍸頶餬鬍魱鰗鵠鶘鶦鶻鹄鹕鹘鼓
fu5	咐
da1	咑哒嗒噠搭撘答耷褡
ka1	咔咖哈喀鉲
lie3	咧裂
lie1	咧
lie5	咧
mi1	咪眯瞇
lo5	咯
luo4	咯嗠峈摞泺洛漯濼濽烙犖珞硌笿絡纙络荦落跞酪雒韷駱骆鮥鴼鵅
zan5	咱
ke2	咳壳榼殻殼頦颏
hui1	咴噕堕墮婎幑徽恢拻挥揮撝晖暉洃瀈灰烣煇珲琿睳禈翚翬虺袆褌褘詼诙豗輝辉隓隳顪鰴麾鼿
kua1	咵夸姱晇荂誇
huai4	咶坏壊壞蘹蘾諙
xian2	咸唌啣娴娹婱嫌嫺嫻弦憪挦撏涎燅甉痃痫癇癎瞯礥絃羬胘舷葴藖蚿蛝衔衘諴賢贒贤輱醎銜閑閒闲鷳鷴鷼鹇鹹
xuan3	咺烜癣癬选選
kuai1	咼喎糩
ai1	哀哎唉埃挨捱銰鎄锿
pin3	品榀
shen3	哂婶嬸审宷寀審弞沈渖瀋瞫矤矧覾訠諗讅谂谉邥頣魫
hong3	哄嗊晎閧
hong4	哄汞澒蕻訌讧鍙閧鬨
wa5	哇
ha1	哈鉿铪
ha3	哈
ha4	哈
zai1	哉栽渽災灾烖甾菑賳
pai4	哌汖派湃蒎鎃
gen2	哏
yue3	哕
mou1	哞
yo5	哟喲
yo1	哟唷喲育
long4	哢弄徿挊挵梇硦衖贚
o2	哦
o4	哦
wo2	哦
li1	哩
li5	哩璃里
nei3	哪脮腇餒馁鮾鯘
ne2	哪
sui1	哸夊奞娞尿毸浽滖濉熣眭睢綏芕荽荾虽雖鞖
hng5	哼
geng3	哽埂峺挭梗綆绠耿莄郠頚頸颈骾鯁鲠
shuo1	哾說説说
han1	唅嫨憨炶犴甝蚶谽酣頇顸馠魽鼾
chun2	唇憌浱淳湻滣漘純纯脣莼蒓蓴醇醕錞陙鯙鶉鹑
jia2	唊圿埉夹夾恝戛戞扴挾梜浹硈筴舺荚莢蛱蛺袷裌跲郏郟鉿鋏铗鞂鞈頬頰颊餄鵊
guan3	唍圕琯痯筦管舘莞輨錧館馆鳤
miu1	唒
n2	唔嗯
n3	唔嗯
ng2	唔嗯
ng3	唔嗯
zao4	唕唣噪慥梍灶燥皁皂竃竈竉簉艁譟趮躁造髞
dou3	唗唞抖敨斗枓枡蚪闘阧陡鬥鬦鬪鬭
suo3	唢嗩所摵暛溑琐琑瑣璅瘷索褨鎍鎖鎻鏁鏼锁
huan4	唤喚喛嚾垸奂奐宦嵈幻患愌换換擐梙槵浣涣渙漶烉焕煥瑍痪瘓瞣觨豢轘逭鯇鰀鲩
feng3	唪覂諷讽
tian3	唺忝悿晪殄淟痶睓腆舔蚕覥觍賟靦餂
tuo4	唾拓柝毤毻箨籜萚蘀跅驝魄
nou4	啂嗕槈耨譨譳鎒鐞
ken3	啃垦墾恳懇肎肯肻豤錹齗齦龈
heng4	啈堼撔横橫澋絎
chuai4	啜嘬揣膪踹
fei1	啡妃婓扉渄緋绯菲蜚裶霏非靟飛飝飞馡騑騛鯡鲱
pi2	啤埤壀朇枇椑毗毘毞焷犤猈玭琵疲皮笓紕罴罷羆肶脾腗膍芘藣蚍蚽蜱螷蠯裨豼貔郫鈚鈹錍铍阰陂陴隦魮魾鮍鲏鼙
sha2	啥
la5	啦蓝藍鞡
la1	啦喇嚹垃拉柆翋菈邋
pa1	啪妑扒派皅舥葩蚆趴
zhe3	啫禇者褶赭鍺锗
se4	啬嗇塞懎擌歮歰涩渋澀澁濇濏瀒犞瑟璱穑穡繬翜色譅趇轖銫铯雭飋
luo1	啰囉寽捋攞罗羅落
tan1	啴坍怹抩探摊擹攤滩灘瘫癱緂舑貪贪
ding4	啶娗定忊掟椗矴碇碠磸腚萣訂订釘鋌錠钉铤锭顁飣饤
lang1	啷
an2	啽玵雸
ka4	喀
la3	喇拉藞
re3	喏惹若
nuo4	喏愞懦懧挼掿搦搻榒稬穤糑糥糯諾诺蹃逽鍩锘
o1	喔噢
du4	喥妒妬度斁杜殬渡秺簵肚芏荰螙蠧蠹鍍镀靯
pen1	喯喷噴歕
miao1	喵
pen4	喷噴
pen5	喷
kui2	喹夔奎戣揆晆暌楏楑櫆湀犪睽聧葵蘷蝰躨逵鄈鍨隗頯馗騤骙魁
lou5	喽嘍
cao1	喿撡操糙鄵
xiu4	嗅宿岫峀殠溴珛琇秀綉繍繡绣臭臰螑袖褎褏銹鏥鏽锈齅
sang3	嗓搡磉褬鎟顙颡
chen1	嗔堔抻搷棽琛瞋諃謓賝郴
sou1	嗖廀廋捜搜摉溲獀艘蒐螋鄋醙鎪锼颼飕餿馊騪
pang3	嗙耪覫
jue1	嗟噘撅
weng1	嗡奣嵡滃翁螉鎓霐鶲鹟
wa4	嗢瓦腽膃袜襪韈韤
hei1	嗨嘿潶黑黒
ng4	嗯
n4	嗯
na2	嗱拏拿挐誽鎿镎
dia3	嗲
tong1	嗵恫樋炵狪痌蓪通
zhe1	嗻嫬折晢晣蜇螫遮
sou4	嗽擞擻瘶
tan3	嗿坦忐憳憻毯璮菼袒裧襢贉醓鉭钽
cao2	嘈嶆曹曺槽漕艚蓸螬褿鏪
ga3	嘎尕玍
ga2	嘎噶尜軋轧釓錷钆
po2	嘙婆櫇皤繁蔢鄱
de1	嘚
dei1	嘚
lei5	嘞
ran2	嘫然燃繎肰蚒蚦蚺蛅衻袇袡髥髯
zhuai4	嘬拽曳曵
chao2	嘲巢巣晁朝樔潮謿轈鄛鼂鼌
can3	噆惨慘憯朁黪黲
ceng1	噌
deng1	噔嬁灯燈璒登竳簦蕽覴豋蹬鐙
lu1	噜嚕撸擼
ying4	噟媵应応應摬映暎瀅硬膡譍賏鎣鐛鞕
yue1	噦曰曱焥箹約约
xue2	噱壆学學峃斅斈泶澩燢穴茓觷踅雤鷽鸴
sai1	噻塞思恖愢揌毢腮顋鰓鳃
o3	嚄
ca1	嚓拆擦
huang1	嚝塃巟慌朚肓荒衁
nang2	嚢囊欜饢馕
pin2	嚬娦嫔嬪瀕矉苹薲蘋貧贫頻顰频颦
rang3	嚷壌壤攘爙禳
rang1	嚷
jiao2	嚼峤矫矯
zhuan3	囀竱転轉转
ca4	囃
chai4	囆瘥虿蠆袃
zan4	囋暂暫欑灒瓉瓒瓚穳襸讃讚賛贊赞趲鄼酇錾鏨饡
su1	囌櫯甦稣穌窣苏蘇蘓酥
hui2	囘回囬廻廽徊恛洄痐茴藱蚘蛔蛕蜖迴逥鮰
nin2	囜恁您
nan1	囝囡
tun2	囤屯忳拵臀臋芚豘豚軘霕飩饨魨鲀
guo2	囯囶囻国圀國帼幗慖掴摑漍簂聝腘膕虢馘
kun4	困涃睏
ri4	囸日氜衵鈤馹驲
pu3	圃圑埔堡普暜朴樸檏氆浦溥烳誧諩譜谱蹼鐠镨
quan1	圈圏弮悛惓棬絟
lve4	圙掠擽攊略畧鋝锊
huan2	圜垸嬛寏寰懁捖桓洹澴狟狥环環瓛糫繯缳羦肒荁萈萑豲貆还還郇鍰鐶锾镮闤阛雈鬟鹮
luan2	圝圞娈孌孪孿峦巒挛攣曫栾欒滦灓灤癴癵羉脔臠虊銮鑾鵉鸞鸾
de5	地底得的
qia4	圶帢恰愘殎洽髂
chang5	场
ban3	坂岅昄板版瓪粄舨蝂鈑钣闆阪
qin3	坅寑寝寢昑曋螼赾鋟锓顉
fen2	坆坟墳妢幩弅枌棼汾濆炃焚燌燓羒蒶蕡蚠蚡豮豶轒鐼馚馩黂鼖鼢
fang2	坊埅妨房肪防魴鲂
po1	坡攴攵朴泊波泺泼溌潑癹翍酦醗鏺钋陂颇
pan3	坢奤
kun1	坤堃婫崐崑惃昆晜焜猑琨瑻菎蜫裈褌貇醌錕锟騉髠髡髨鯤鲲鵾鹍
long3	垄垅壟壠拢攏笼篭籠陇隴
dui1	垖堆塠嵟痽磓頧
shou3	垨守手扌掱艏首
da5	垯塔墖墶疸瘩跶
cen2	埁岑梣橬涔笒
mai2	埋薶霾
man2	埋悗慲摱槾漫璊瞒瞞蔓蛮蠻謾谩蹣鞔顢饅馒鬗鬘鰻鳗
lang4	埌崀浪莨蒗郎郒閬阆
lun3	埨稐耣
cai4	埰縩菜蔡采
beng3	埲玤琫綳绷菶誁鞛
pei2	培毰荖裴裵賠赔錇锫阫陪陫
sao4	埽扫掃梢氉瘙臊
beng4	堋槰泵甏綳绷蚌蜯跰蹦迸逬鏰镚
peng4	堋掽椪碰
leng4	堎愣楞踜
hun2	堚忶棞楎浑混渾珲琿繉轋顐餛餫馄魂鼲
lian4	堜媡恋戀斂楝歛殓殮湅潋澰澵瀲炼煉瑓練纞练萰薟蘝蘞襝錬鍊鏈链鰊
pu4	堡暴曝瀑舖舗鋪铺鮬
ruan2	堧壖撋
du3	堵帾暏琽睹笃篤肚裻覩賭赌錖
gang3	塂岗崗港
duan4	塅断斷椴段毈煅瑖碫簖籪緞缎腶葮躖鍛锻
ta3	塔墖榙溚獭獺鎝鰨鳎
wen1	塭昷殟温溫瑥瘟瞃蕰豱輼轀辒馧鰛鰮鳁
lang3	塱峎斏朖朗朤樃烺焃硠誏閬
shuang3	塽慡樉漺爽縔騻
lou3	塿嵝嶁搂摟甊篓簍
chen3	墋捵硶碜磣裖贂趻踸鍖齓
zeng1	増增憎曽曾橧熷璔矰磳繒缯罾譄驓
dong3	墥嬞懂硐箽董
zun1	墫壿尊嶟樽燇繜罇遵鐏鱒鳟鷷
mu2	墲模橅毪氁
lan3	壈嬾孄孏懒懶揽擥攬榄欖浨漤灠爦纜缆罱覧覽览醂顲
lan4	壏滥濫烂燗爁爛爤爫瓓纜鑭
lei2	壨嫘擂檑櫑欙瓃畾礌累縲纍纝缧罍羸蠝轠鐳鑘镭雷靁鼺
kun3	壸壼悃捆梱硱祵稇稛綑裍閫閸阃齫
mang3	壾庬汒漭硥茻莽莾蟒蠎
qun1	夋峮踆逡
xiong4	夐敻詗诇
wai4	外
meng4	夢夣孟梦溕霥霿
da4	大眔
hang1	夯
gao3	夰搞攪暠杲槁檺稾稿筶縞缟菒藁藳鎬镐
ben3	夲奙本楍畚苯
en1	奀恩蒽
pao4	奅泡炮疱皰砲礟礮靤髱麭
zou4	奏揍驟
she1	奓奢檨猞畲譇賒賖赊
ben1	奔栟泍渀犇賁贲逩錛锛
jiang3	奖奨奬桨槳滰獎耩膙蒋蔣講讲顜
tao4	套
zhuang3	奘弉
huang3	奛宺幌怳恍晃晄榥洸滉熀皝縨詤謊谎鎤
yun1	奫晕暈氲氳煴煾熉緼縕蒀蒕蝹贇赟
nv3	女籹釹钕
nu2	奴孥笯蒘駑驽
ding3	奵嵿檙濎薡酊鐤頂顶鼎鼑
hao3	好恏郝
fan4	奿嬎嬔梵氾汎泛滼犯畈盕笵範范訉販贩軓軬鄤飯飰饭
wang4	妄往徃忘旺望朢王莣迋
zhuang1	妆妝娤庄桩梉樁粧糚荘莊装裝
ma1	妈媽嬤嬷抹摩擵蔴蚂螞麻
miao4	妙庙庿廟玅竗繆缪
niu1	妞
tuo3	妥媠嫷庹彵撱椭楕橢鰖鵎
ni1	妮姄
zhou2	妯妰碡軸轴
yuan3	妴远逺遠
tou3	妵媮紏蘣鈄钭黈
e1	妸妿娿婀屙峉痾錒阿
mei4	妹媚寐昧沬煝瑁痗眛睸祙蝞袂謎谜跊韎鬽魅
jie3	姐媎解觧飷
pin1	姘拚拼涄礗
kuo4	姡廓彍扩拡括挄擴栝桰漷濶籗蛞适適闊阔霩鞟鞹
nian2	姩年秊秥粘鮎鯰鲇鲶黏
wa2	娃
rao3	娆嬈扰擾繞绕
rao2	娆嬈桡橈苚荛蕘蟯襓饒饶
niang2	娘嬢孃酿
tui4	娧煺蛻蜕褪退駾
zhui1	娺桘椎腄追錐锥隹騅骓鴭鵻
mian2	婂媔嬵宀棉檰櫋眠矈矊矏綿緜绵臱芇蝒
shu3	婌属屬数數暑曙潻癙糬署薥薯藷蜀襩钃韣黍鼠鼡
wo3	婐我捰
rui2	婑甤緌蕤
hun1	婚惛惽敯昏昬棔殙涽睧睯荤葷閽阍
chou1	婤抽搊犨犫瘳篘霌
nan4	婻难難
rou2	媃揉柔楺沑渘瑈瓇禸糅腬葇蝚蹂輮鍒鞣韖騥鰇鶔
ruan3	媆朊瑌瓀碝礝緛耎腝蝡蠕軟輭软阮
chun1	媋旾春暙杶椿櫄焞瑃箺膥萅蝽輴鰆鶞
ao3	媪媼抝拗芺袄襖镺
zou1	媰掫棷棸箃緅菆諏謅诹邹郰鄒鄹陬騶驺鯫鲰黀齺
rong2	媶容嵘嵤嶸戎曧栄榕榮榵毧溶瀜烿熔爃狨瑢穁絨縙绒羢肜茙茸荗荣蓉蝾融螎蠑褣鎔鎹镕駥髶鰫鷛
sao3	嫂扫掃
niao3	嫋嫐嬝嬲樢茑蔦袅裊褭鳥鸟
bao2	嫑瓝窇薄雹
piao2	嫖朴淲瓢竂闝
man1	嫚顢颟
kang1	嫝康忼慷槺漮穅粇糠躿鏮閌闶鱇
nen4	嫩嫰恁
zhan3	嫸展崭嶃嶄搌斩斬榐樿橏琖皽盏盞蹍輾辗醆颭飐魙
chan1	嬓惉掺搀摻攙梴欃袩襜覘觇辿鋓
can2	嬠嬱惭慙慚残殘蚕蝅蠶蠺
tiao3	嬥宨挑斢晀朓窕誂
shuai1	孈摔縗衰
zi5	子
zi2	子
cun2	存袸蹲
sun1	孙孫搎槂狲猻荪蓀蕵薞飧飱
hai2	孩还還骸
nao1	孬峱
can4	孱惨慘掺澯灿燦璨粲薒
xiao2	學崤洨淆笅訤誵郩
bo4	孹挀掰播擘柏檗狛疈簸繴薄薜蘗譒
nai2	孻摨熋
zhai2	宅択择擇礋翟
zhe4	宅柘檡浙烢蔗蟅这這鷓鹧
song4	宋訟誦讼诵送頌颂餸
rou4	宍肉
zhun1	宒屯窀肫衠訰諄谆迍
chong3	宠寵
qun2	宭帬羣群裙裠麇麏麕
jia5	家
kuan1	宽寛寬臗髋髖
xiu3	宿朽滫糔綇
xin2	寻尋攳杺樳襑鄩鐔镡
xiao3	小晓暁曉皢筱筿篠謏
shao3	少
er3	尒尓尔峏栮洱爾珥耳薾迩邇鉺铒餌饵駬
ga4	尬
kao1	尻髛鷱
niao4	尿溺脲
ceng2	层層嶒曽曾碀竲鄫
diao3	屌鸟
man3	屘満满滿矕螨蟎襔鏋
lou4	屚漏瘘瘺瘻鏤鐚镂陋露
zhai3	岝窄鉙飵
gou3	岣枸狗玽笱耇耉苟茍茩蚼豿
po4	岶廹朴樸泊洦炇烞珀破砶粕蒪迫醱魄
min2	岷崏忞忟怋捪旻旼暋民玟珉琘瑉痻盿砇碈緍緡缗罠苠鈱錉鍲閺
ye2	峫捓揶擨椰爷爺琊瑘耶邪釾鋣鎁铘
bu1	峬庯晡逋鈽钸餔鵏
chong2	崇崈漴痋种種翀虫蝩蟲褈重隀
wai3	崴
cuo2	嵯嵳痤瘥矬蔖虘酂醝鹺鹾
qian3	嵰槏浅淺繾缱肷膁蜸譴谴遣
sui3	嶲巂瀡膸靃髄髓
ying3	巊影景梬浧潁瀴璄瘿癭矨穎郢頴颍颕颖
chuan1	巛川氚瑏穿窓鐉
qiao3	巧悄愀釥雀鵲
hang4	巷沆行
pa4	帊帕怕絈袙
tie1	帖怗萜貼贴
tie4	帖蛈飻餮
zhou3	帚晭疛睭箒肘菷鯞
shui4	帨涗涚睡瞓祱稅税蛻裞說説说
sen1	幓曑森椮槮穼篸罧蔘襂
chuang2	幢床撞橦疒
mie4	幭懱搣櫗滅瀎灭礣篾蔑薎蠛衉衊覕鑖鱴鴓
guang3	广広廣犷獷
mo5	庅麼
geng1	庚揯搄更浭畊粳絙絚緪縆羮羹耕菮賡赓鶊鹒
qing3	庼廎檾綮苘請謦请頃顷
nong4	弄挊挵
zhen3	弫抌抮昣晸枕槇畛疹眕祳稹笉紾絼縝縥缜聄袗診诊軫轸辴鬒黕黰
shao1	弰捎旓梢烧焼燒稍筲艄莦蕱蛸輎鞘髾鮹
tuan4	彖褖
wang3	往徃徍忹惘暀枉棢瀇網网罓罔臦菵蛧蝄誷輞辋迬魍
cu2	徂殂豠
hen3	很狠詪
de2	得徳德恴悳惪棏淂鍀锝
dei3	得
zong4	從昮猔疭瘲碂粽糉糭綜縦縱纵
gai3	忋改攺絠胲
ren3	忍栠栣棯秹稔腍荏荵
te4	忑忒慝特蚮螣蟘貣鋱铽鴏
tui1	忒推蓷藬
tei1	忒
niu3	忸扭杻炄狃紐纽莥鈕钮靵
nv4	忸恧朒衂衄
zen3	怎
ze3	怎
yang4	怏恙样様樣漾瀁烊煬羕詇鞅養
nu4	怒搙
hen4	恨
e3	恶悪惡
hui3	悔會檓毀毁毇烠燬虫虺誨譭賄
men4	悶懑懣焖燜闷
men1	悶闷
qing5	情
guo3	惈果椁槨淉猓粿綶菓蜾裹輠錁鐹餜馃
nie1	惗捏揑踗鈢鑈
rui3	惢桵橤繠蕊蕋蘂蘃
mou4	愗
huang4	愰晃晄皩軦
zheng3	愸抍拯撜整氶糽
cao3	愺懆艸艹草騲
sun4	愻潠
sao1	慅掻搔溞繅缫缲臊艘颾騒騷骚鯵鰠鰺鱢鳋
huang5	慌荒
kang3	慷
lv2	慺榈櫖櫚氀膢藘閭闾馿驢驴
bie1	憋瘪癟虌鱉鳖鼈龞
chou4	憱殠臭臰霔
sheng2	憴渑溗澠縄繩绳譝鱦
mo3	懡抹抺
rang4	懹瀼譲讓让
huan1	懽欢歓歡犿獾讙貛酄驩鴅鵍
nan3	戁揇湳腩蝻赧
gang4	戅戆杠槓焵筻鋼钢
qu5	戌
cai2	戝才材溨纔裁財财
deng3	戥朩等
chuo1	戳踔
pa2	扒掱杷潖爬琶筢耙跁鈀钯
da3	打
reng1	扔
kang2	扛
ban1	扳搬攽斑斒朌班瘢癍肦般虨螌褩辬頒颁
pan1	扳攀潘畨番眅砙
zhao3	找沼爪爯瑵菬
kuang2	抂狂誑诳鵟
ba3	把欛鈀钯靶
zhua1	抓挝撾檛莴髽
pou2	抔抙捊掊裒
pao1	抛拋泡炮脬
lun1	抡掄
nian1	拈蔫
nian3	拈捻撚撵攆涊碾簐跈蹨躎輦辇鯰齳
pai1	拍
lin1	拎
guai3	拐枴柺箉
niu4	拗
yao4	拗曜熎燿獟疟瘧矅穾筄耀艞药葯薬藥袎要覞讑趭鑰钥靿鷂鹞
qia2	拤
ning3	拧擰橣矃
hen2	拫痕鞎
nin3	拰
shuan1	拴栓閂闩
zhuai1	拽
kua4	挎胯跨骻
keng3	挳
lao1	捞撈
sun3	损損榫笋筍箰簨鎨隼
peng3	捧淎皏
she3	捨舍舎
duo5	掇
gun3	掍滚滾磙緄绲蓘蔉衮袞輥辊鮌鯀鲧
lve3	掠
kong4	控空鞚
tian4	掭煔瑱舚
ken4	掯珢硍裉褃
bai1	掰擘
miao2	描瞄緢苗鱙鶓鹋
chuai3	揣
chuai1	揣搋
lou1	搂摟
cuo1	搓撮睉磋蒫蹉遳髊
qiu3	搝糗
chuang3	搶摤漺闖闯
en4	摁
tang4	摥烫燙趟鐋
mo1	摸
liao1	撂撩蹽
pie1	撆撇暼氕瞥
sa3	撒洒潵灑訯靸
cuo3	撮瑳硰縒脞
cuan1	撺攛汆蹿躥鋑鑹镩
kuo3	擃
cao4	操肏襙
kuai3	擓蒯
xing3	擤渻省睲醒
zuan4	攥賺赚鑚鑽钻饡
nang3	攮曩灢饢馕
fang4	放趽
san5	散
wen2	文炆玟珳琝璺瘒紋纹聞芠蚉蚊螡蟁閺閿闅闦闻阌雯馼駇魰鳼鴍鴖鼤
dou4	斗斣梪毭浢痘窦竇脰荳読讀读豆逗鋀閗闘餖饾鬥鬦鬪鬬鬭
tou4	斢透
jin5	斤
zao3	早枣棗澡璪繰缲薻藻蚤
pei3	昢琣
shai4	晒曬殺閷
zhe5	晢着著遮
nuan3	暖渜煖煗餪
men3	暪
tiao4	朓眺窱粜糶絩脁覜跳
cun1	村澊皴竴邨
miao3	杪杳淼渺眇秒篎緲缈藐邈
ang4	枊盎醠
bian1	柉楄煸牑猵獱甂砭稨笾箯籩編编蝙边辺邉邊鍽鞭鯾鯿鳊
liu3	柳栁桺橮珋綹绺罶羀鉚鋶锍飹
guang4	桄櫎矌臦臩逛
ting4	梃聽
kuan3	梡欵款歀窾
gun4	棍璭睴
leng1	棱
ku3	楛苦
bang3	榜牓牕綁绑膀髈
gao1	槔槹橰櫜滜皋皐睪睾篙糕羔羙膏臯韟餻高髙鼛
run4	橍润潤膶閏閠闰
shun4	橓瞚瞬舜蕣順顺鬊
nuo3	橠砈
cong4	欉藂謥
qian5	欠
e^1	欸誒诶
e^2	欸誒诶
e^3	欸誒诶
e^4	欸誒诶
wai1	歪
si3	死
piao3	殍漂犥皫瞟縹缥莩醥鷅
cuan4	殩熶爨窜竄篡篹簒
lu5	氇轳
shui3	水氵氺
tun3	氽畽
ta5	沓
zhui3	沝
hai3	海烸胲酼醢
shuan4	涮腨
nao4	淖臑閙闹鬧
fei2	淝肥腓萉蜰
hun3	混睔鯶
re4	渃热熱
tuan1	湍煓猯貒
pen2	湓瓫盆葐
liu1	溜澑熘
lun4	溣論论
cui3	漼璀趡
huan3	澣皖睆緩缓藧輐
neng4	濘
shuang4	灀
pang4	炐肨胖
que1	炔缺缼蒛闕阙
dian5	点
rou3	煣粈糅鍕
xiong2	熊赨雄
shou2	熟
teng1	熥膯鼟
zhua3	爪
die1	爹褺跌踮
zang1	牂牃羘脏臧賍賘贓贜赃鍺锗髒
pian4	片遍騗騙骗
niu2	牛
pin4	牝聘
run1	犉
kao4	犒銬铐靠鲓
chuo2	犳
suan1	狻痠酸
mao1	猫貓
nou2	獳羺
weng4	瓮甕罋蕹齆
zeng4	甑綜繒综缯贈赠鋥锃
shuai3	甩
beng2	甭
tuan3	疃黗
nve4	疟瘧虐謔
bie3	瘪癟蛂
que2	瘸
bai2	白
dun3	盹趸躉
mian4	眄粫糆面靣麪麵麺
zhao2	着著
run2	瞤
ju5	矩
duan3	短鍴
zhou5	碡
ca3	礤
suan4	祘笇筭算蒜
zu1	租菹蒩
zhun4	稕
jun3	窘蜠
huai1	竵
shai1	筛篩簛籭酾
ji5	箕辑
bo3	箥簸蚾跛駊
fen3	粉黺
cu1	粗觕麁麄麤
ping3	絣
gei3	給给
sui2	綏绥遀遂隋随隨雟
miu4	繆缪謬谬
rao4	繞绕遶隢
shai3	繺色骰
rao5	绕
chuo5	绰
luo5	罗
gou2	耈
shua3	耍
le1	肋
ang1	肮骯
shui2	脽誰谁
guo4	腂过過
chuai2	膗
xue3	膤雪鱈鳕
gen3	艮
reng4	芿
nie2	苶
chai3	茝
bi2	荸鼻
meng1	蒙
lan5	蓝
xu5	蓿
ha2	虾蛤蝦鰕
tun4	螁褪
gun1	裩
shang5	裳
lai3	襰
pian3	覑諞谝
tao3	討讨
shei2	誰谁
zen4	譖譛谮
ei4	诶
ei2	诶
ei3	诶
zei2	賊贼鱡鲗
cang4	賶
zou3	走赱
qie5	趄
pao3	跑
zhuai3	跩転轉转
ceng4	蹭
jue3	蹶
zuan1	躜躦鑚鑽钻
ang3	軮
bian5	边
zhei4	这這
suo4	逤
niang4	酿醸釀
liang5	量
lue2	鐚
long1	隆霳
eng1	鞥
tou5	頭
tun5	飩饨
zang3	駔驵
gu2	骨鶻
yiao1	鴁
nu1	鴑
rong4	鴧
nen1	黁
qui2	鼽
hou1	齁
